#Draft Emoji Annotations

#Finer-grained character annotations. For brevity, flags are not shown: they would have names of the associated countries. For more information, see Unicode Emoji.

ab	ğŸ†
abc	ğŸ”¤
access	â™¿ï¸
ace	ğŸ‚¡ ğŸ‚± ğŸƒ ğŸƒ‘
public address	ğŸ“¢
admission	ğŸ« ğŸŸ
aerial	ğŸš¡
aesculapius	âš•
africa	ğŸŒ
airplane	âœˆï¸ ğŸ›¦ ğŸ›§ ğŸ›¨ ğŸ›© ğŸ›ª ğŸ›« ğŸ›¬
departures, check-in	ğŸ›«
age restriction	ğŸ”
arrivals	ğŸ›¬
alarm	â°
alembic	âš—
alien	ğŸ‘½ ğŸ‘¾
alphabet	ğŸ”¤
alternate	â›•
ambulance	ğŸš‘
americas	ğŸŒ
unhappy	ğŸ˜’
anchor,ship,tool	âš“ï¸ ğŸ”±
angel	ğŸ‘¼ğŸ˜‡
anger	ğŸ’¢ ğŸ—® ğŸ—¯ ğŸ˜ ğŸ˜ 
ğŸ˜¡
anguished	ğŸ˜§
animal	ğŸ€ ğŸ ğŸ‚ ğŸƒ ğŸ„ ğŸ… ğŸ† ğŸ‡ ğŸˆ ğŸ‰ ğŸŠ ğŸ‹ ğŸŒ ğŸ ğŸ ğŸ ğŸ ğŸ‘ ğŸ’ ğŸ“ ğŸ” ğŸ• ğŸ– ğŸ— ğŸ˜ ğŸ™ ğŸš ğŸ› ğŸœ ğŸ ğŸ ğŸŸ ğŸ  ğŸ¡ ğŸ¢ ğŸ£ ğŸ¤ ğŸ¥ ğŸ¦ ğŸ§ ğŸ¨ ğŸ© ğŸª ğŸ« ğŸ¬ ğŸ­ ğŸ® ğŸ¯ ğŸ° ğŸ± ğŸ² ğŸ³ ğŸ´ ğŸµ ğŸ¶ ğŸ· ğŸ¸ ğŸ¹ ğŸº ğŸ» ğŸ¼ ğŸ½ ğŸ¾ ğŸ¿ ğŸ‘½ ğŸ‘¾ ğŸ•Š ğŸ•· ğŸ•¸ ğŸ˜¸ ğŸ˜¹ ğŸ˜º ğŸ˜» ğŸ˜¼ ğŸ˜½ ğŸ˜¾ ğŸ˜¿ ğŸ™€
ant	ğŸœ
antenna	ğŸ“¡ ğŸ“¶
anticlockwise, counterclockwise	ğŸ”„
apology	ğŸ™‡
apple	ğŸ ğŸ
aquarius	â™’ï¸
aries	â™ˆï¸
arrow	â†”ï¸ â†•ï¸ â†–ï¸ â†—ï¸ â†˜ï¸ â†™ï¸ â†©ï¸ â†ªï¸ â© âª â« â¬ â¡ï¸ â¤´ï¸ â¤µï¸ â¬…ï¸ â¬†ï¸ â¬‡ï¸ ğŸ’˜ ğŸ“© ğŸ“² ğŸ”€ ğŸ” ğŸ”‚ ğŸ”ƒ ğŸ”„ ğŸ”™ ğŸ”š ğŸ”› ğŸ”œ ğŸ” ğŸ—˜
art	ğŸ­
art	ğŸ¨
brightness	ğŸ”…
ğŸ”†
ascending	ğŸœ
asia	ğŸŒ
asterisk	âœ³ï¸
astonished	ğŸ˜²
athletic,shoe	ğŸ‘Ÿ
atm,sign,bank	ğŸ§
atom	âš›
aubergine	ğŸ†
australia	ğŸŒ
automated	ğŸ§
automobile	ğŸš— ğŸš˜
autumn	ğŸ€¨
baby	ğŸ¼ ğŸ£ ğŸ¤ ğŸ¥ ğŸ‘¶ ğŸ‘¼ ğŸš¼
back	ğŸ€« ğŸ€° ğŸ¢ ğŸ‚  ğŸ”™ ğŸ–‚
backhand	ğŸ‘† ğŸ‘‡ ğŸ‘ˆ ğŸ‘‰ ğŸ–œ ğŸ– ğŸ–¢ ğŸ–£
bactrian	ğŸ«
badge	ğŸ“›
bag	ğŸ’ ğŸ‘œ ğŸ‘ ğŸ’° ğŸ›
baggage	ğŸ›„ ğŸ›…
balance	âš–
ball	âš½ï¸ âš¾ï¸ â›¹ ğŸ™ ğŸŠ ğŸ± ğŸ³ ğŸ¾ ğŸ€ ğŸˆ ğŸ‰ ğŸŒ ğŸ”®
balloon	ğŸˆ ğŸ’¬ ğŸ’­ğŸ’¬ ğŸ’­ ğŸ—¨ ğŸ—© ğŸ—ª ğŸ—« ğŸ—¬ ğŸ—­ ğŸ—® ğŸ—¯ ğŸ—° ğŸ—±
ballot	â˜ â˜‘ï¸ â˜’ âœ— âœ˜  ğŸ—³
barber	ğŸ’‡
ballpoint	ğŸ–Š
bamboo	ğŸ€ ğŸ€‘ ğŸ€’ ğŸ€“ ğŸ€” ğŸ€• ğŸ€– ğŸ€— ğŸ€˜ ğŸ€¤
banana	ğŸŒ
bank	ğŸ¦ ğŸ’´ ğŸ’µ ğŸ’¶ ğŸ’· ğŸ’¸
banknote	ğŸ’´ ğŸ’µ ğŸ’¶ ğŸ’· ğŸ’¸
banner	ğŸ‹
bar,drink	ğŸ¶
ğŸ·
ğŸ¸
ğŸ¹
ğŸº
ğŸ»
ğŸ®
beverage,drink	ğŸ¶
ğŸ·
ğŸ¸
ğŸ¹
ğŸº
ğŸ»
bar chart	ğŸ“Š
restaurant	ğŸ¶
ğŸ·
ğŸ¸
ğŸ¹
ğŸº
ğŸ»
ğŸ®
barber	ğŸ’ˆ
baseball	âš¾ï¸
basketball	ğŸ€
bath	ğŸ›€ ğŸ›
bathtub	ğŸ›€ ğŸ›
battery	ğŸ”‹
beach	ğŸ–
beacon	ğŸš¨
beamed	â™« â™¬ ğŸœ ğŸ
bear	ğŸ¨ ğŸ»
beating	ğŸ’“
beauty	ğŸ’‡
bed	ğŸ› ğŸ›Œ
bee	ğŸ
beer	ğŸº ğŸ»
beetle	ğŸ
bell	â¾ ğŸ”” ğŸ”• ğŸ•­ ğŸ› ğŸ
bellhop	ğŸ›
bento	ğŸ±
beverage	â˜•ï¸
biceps	ğŸ’ª
bicycle,bike	ğŸš² ğŸš³ ğŸš´ ğŸšµ
bikini,swim	ğŸ‘™
bill	ğŸ’´ ğŸ’µ ğŸ’¶ ğŸ’· ğŸ’¸
billiard	ğŸ±
biohazard	â˜£
bird	ğŸ¦
birthday	ğŸ‚
bishop	â™— â™
blond	ğŸ‘±
blood	ğŸ…° ğŸ† ğŸ…± ğŸ…¾
blossom	ğŸŒ¸ ğŸŒ¼
blow	ğŸŒ¬ ğŸƒ
blowfish	ğŸ¡
blue	ğŸ’™ ğŸ“˜ ğŸ”µ ğŸ”· ğŸ”¹ ğŸ˜°
blu-ray	ğŸ’¿
boar	ğŸ—
boat	â›µï¸ ğŸ›¥ ğŸš£ â›´ ğŸš¤
amusement park	ğŸ¡
ğŸ¢
bolt	ğŸ”©
bomb	ğŸ’£
bone	ğŸ–
book	ğŸ“” ğŸ“• ğŸ“– ğŸ“— ğŸ“˜ ğŸ“™ ğŸ“š ğŸ•®
bookmark	ğŸ“‘ ğŸ”–
boot	ğŸ‘¢
bottle	ğŸ¶ ğŸ¼
bouquet	ğŸ• ğŸ’
bow	ğŸ™‡
bowl	ğŸœ
bowling	ğŸ³
box	â˜ â˜‘ï¸ â˜’ ğŸ± ğŸ“¤ ğŸ“¥ ğŸ“¦ ğŸ—ƒ ğŸ—³
boy	ğŸ‘¦ ğŸ›‰
branch	â¸™
bread	ğŸ
break	ğŸ’”
bride	ğŸ‘°
bridge	ğŸŒ‰
briefcase	ğŸ’¼
bright	 ğŸ”†ğŸ˜ â˜€ï¸ â˜¼ ğŸŒ ğŸŒ ï¸ ğŸŒ£
broken	ğŸ’”
bubble	ğŸ’¬ ğŸ’­ ğŸ—¨ ğŸ—© ğŸ—ª ğŸ—« ğŸ—¬ ğŸ—­ ğŸ—® ğŸ—¯ ğŸ—° ğŸ—±
buffalo	ğŸƒ
bug	ğŸ›
building	â›ªï¸ ğŸŒ† ğŸŒ‡ ğŸ— ğŸ˜ ğŸ™ ğŸš ğŸ› ğŸ  ğŸ¡ ğŸ¢ ğŸ¥ ğŸ¨ ğŸ© ğŸª ğŸ« ğŸ¬ ğŸ¯ ğŸ°ğŸ£
ğŸ¤
ğŸ¦
ğŸ­
ğŸŒ‡
bulb	ğŸ’¡
bullet	â˜™ â¥ â§ ğŸš…
bullhorn	ğŸ•« ğŸ•¬
bullâ€™s eye	ğŸ¯
bunny	ğŸ‘¯
burger	ğŸ”
bus	ğŸšŒ ğŸš ğŸš ğŸš ğŸš
business	ğŸ•´
bust	ğŸ‘¤ ğŸ‘¥
button	ğŸ”˜ ğŸ”² ğŸ”³ ğŸ”¼ ğŸ”½ ğŸ–¯ ğŸ–° ğŸ–±
cabinet	ğŸ—„
cable	ğŸš  ğŸš¡
cactus	ğŸŒµ
caduceus	â˜¤
cake,pastry	ğŸ¥ ğŸ° ğŸ‚
calculator	ğŸ–©
calendar	ğŸ“… ğŸ“† ğŸ—“
call	ğŸ“²
camel	ğŸª ğŸ«
camera	ğŸ¥ ğŸ¦ ğŸ“· ğŸ“¸ ğŸ“¹
camping	â›ºï¸ ğŸ•
cancer	â™‹ï¸
candle,light	ğŸ•¯
candy	ğŸ¬ ğŸ­
cap,hat	ğŸ“
capricorn	â™‘ï¸
car	â› â› ğŸ ğŸšƒ ğŸš‹ ğŸš“ ğŸš” ğŸš— ğŸš˜ ğŸš ğŸš¡ ğŸš¨
card	â™ ï¸ â™¡ â™¢ â™£ï¸ â™¤ â™¥ï¸ â™¦ï¸ â™§ ğŸ‚  ğŸ‚¡ ğŸ‚¢ ğŸ‚£ ğŸ‚¤ ğŸ‚¥ ğŸ‚¦ ğŸ‚§ ğŸ‚¨ ğŸ‚© ğŸ‚ª ğŸ‚« ğŸ‚¬ ğŸ‚­ ğŸ‚® ğŸ‚± ğŸ‚² ğŸ‚³ ğŸ‚´ ğŸ‚µ ğŸ‚¶ ğŸ‚· ğŸ‚¸ ğŸ‚¹ ğŸ‚º ğŸ‚» ğŸ‚¼ ğŸ‚½ ğŸ‚¾ ğŸ‚¿ ğŸƒ ğŸƒ‚ ğŸƒƒ ğŸƒ„ ğŸƒ… ğŸƒ† ğŸƒ‡ ğŸƒˆ ğŸƒ‰ ğŸƒŠ ğŸƒ‹ ğŸƒŒ ğŸƒ ğŸƒ ğŸƒ ğŸƒ‘ ğŸƒ’ ğŸƒ“ ğŸƒ” ğŸƒ• ğŸƒ– ğŸƒ— ğŸƒ˜ ğŸƒ™ ğŸƒš ğŸƒ› ğŸƒœ ğŸƒ ğŸƒ ğŸƒŸ ğŸƒ  ğŸƒ¡ ğŸƒ¢ ğŸƒ£ ğŸƒ¤ ğŸƒ¥ ğŸƒ¦ ğŸƒ§ ğŸƒ¨ ğŸƒ© ğŸƒª ğŸƒ« ğŸƒ¬ ğŸƒ­ ğŸƒ® ğŸƒ¯ ğŸƒ° ğŸƒ± ğŸƒ² ğŸƒ³ ğŸƒ´ ğŸƒµ ğŸ´ ğŸ’³ ğŸ“‡ ğŸ—‚ ğŸ—ƒ
care	ğŸ’…
carousel	ğŸ 
carp	ğŸ
castle	ğŸ¯ ğŸ°
cat	ğŸˆ ğŸ± ğŸ˜¸ ğŸ˜¹ ğŸ˜º ğŸ˜» ğŸ˜¼ ğŸ˜½ ğŸ˜¾ ğŸ˜¿ ğŸ™€
cd	ğŸ’¿
celebration	ğŸ€ ğŸ ğŸ‚ ğŸƒ ğŸ„ ğŸ… ğŸ† ğŸ‡ ğŸˆ ğŸ‰ ğŸŠ ğŸ‹ ğŸŒ ğŸ ğŸ ğŸ ğŸ ğŸ‘  ğŸ“ ğŸ” ğŸ• ğŸ– ğŸ— ğŸ™Œ
cell	ğŸ“± ğŸ“² ğŸ“³ ğŸ“´ ğŸ“µ
ceremony	ğŸ‘
chain	â›“
chair	ğŸ’º
changing	ğŸš¼
chapel	ğŸ’’
chart	ğŸ’¹ ğŸ“ˆ ğŸ“‰ ğŸ“Š ğŸ— 
check	â˜‘ï¸ âœ… âœ”ï¸
checkered,racing	ğŸ
checkers	â›€ â› â›‚ â›ƒ
chequered	ğŸ
cherry	ğŸŒ¸ ğŸ’
chess	â™” â™• â™– â™— â™˜ â™™ â™š â™› â™œ â™ â™ â™Ÿ
chestnut	ğŸŒ°
chevron	ğŸ”°
chick	ğŸ£ ğŸ¤ ğŸ¥
chicken	ğŸ— ğŸ”
child	ğŸ‘ª ğŸš¸
chime	ğŸ
chipmunk	ğŸ¿
chocolate	ğŸ«
christmas	ğŸ„ ğŸ…
chrysanthemum	ğŸ€¥
church	â›ªï¸
cinema	ğŸ¥ ğŸ¦
circle	âº âšªï¸ âš«ï¸ â›’ â› â­•ï¸ ğŸ€™ ğŸ€š ğŸ€› ğŸ€œ ğŸ€ ğŸ€ ğŸ€Ÿ ğŸ€  ğŸ€¡ ğŸ”´ ğŸ”µ ğŸ”¾ ğŸ”¿ ğŸ—Ÿ ğŸ›ˆ â“‚ï¸
circus	ğŸª
citrus	ğŸ‹
city	ğŸŒ† ğŸ™
cl	ğŸ†‘
clamshell phone	ğŸ–
clap	ğŸ‘
clapper	ğŸ¬
classical	ğŸ›
clenched	ğŸ‘Š âœŠ
clink	ğŸ»
clipboard	ğŸ“‹
clock	âŒšï¸ â° â± â² ğŸ• ğŸ•‘ ğŸ•’ ğŸ•“ ğŸ•” ğŸ•• ğŸ•– ğŸ•— ğŸ•˜ ğŸ•™ ğŸ•š ğŸ•› ğŸ•œ ğŸ• ğŸ• ğŸ•Ÿ ğŸ•  ğŸ•¡ ğŸ•¢ ğŸ•£ ğŸ•¤ ğŸ•¥ ğŸ•¦ ğŸ•§ ğŸ•°
clockwise	ğŸ” ğŸ”‚ ğŸ”ƒ ğŸ—˜
closed	ğŸ“• ğŸ“ª ğŸ“« ğŸ” ğŸ”’ğŸ˜š
tongue	ğŸ˜›
ğŸ˜œ
ğŸ˜
clothing	ğŸ‘‘ ğŸ‘’ ğŸ‘“ ğŸ‘” ğŸ‘• ğŸ‘– ğŸ‘— ğŸ‘˜ ğŸ‘™ ğŸ‘š ğŸ‘› ğŸ‘œ ğŸ‘ ğŸ‘ ğŸ‘Ÿ ğŸ‘  ğŸ‘¡ ğŸ‘¢
cloud	â˜ï¸ â›…ï¸ â›† â›ˆ ğŸŒ¤ ğŸŒ¥ ğŸŒ¦ ğŸŒ§ ğŸŒ¨ ğŸŒ© ğŸŒª ğŸŒ« ğŸŒ¬
clover	ğŸ€
club	â™£ï¸ â™§ ğŸƒ‘ ğŸƒ’ ğŸƒ“ ğŸƒ” ğŸƒ• ğŸƒ– ğŸƒ— ğŸƒ˜ ğŸƒ™ ğŸƒš ğŸƒ› ğŸƒœ ğŸƒ ğŸƒ
coaster	ğŸ¢
cocktail	ğŸ¸
coffee,beverage	â˜•ï¸
coffin	âš°
coin	ğŸ‘›
cold	â˜ƒ â›„ï¸ â›‡ â„ï¸ ğŸŒ¨ ğŸ” ğŸ’§ ğŸ˜… ğŸ˜“ ğŸ˜° ğŸ˜·
collision	ğŸ’¥
comet	â˜„
comic	ğŸ’  ğŸ’¡ ğŸ’¢ ğŸ’£ ğŸ’¤ ğŸ’¥ ğŸ’¦ ğŸ’§ ğŸ’¨ ğŸ’© ğŸ’ª ğŸ’« ğŸ’¬ ğŸ’­ ğŸ—¤ ğŸ—¥ ğŸ—¦ ğŸ—§
communication	ğŸ“ ğŸ“ ğŸ“Ÿ ğŸ“  ğŸ“¡ ğŸ“¢ ğŸ“£ ğŸ“¤ ğŸ“¥ ğŸ“¦ ğŸ“§ ğŸ“¨ ğŸ“© ğŸ“ª ğŸ“« ğŸ“¬ ğŸ“­ ğŸ“® ğŸ“¯ ğŸ“° ğŸ“± ğŸ“² ğŸ“³ ğŸ“´ ğŸ“µ ğŸ“¶ ğŸ•¨ ğŸ•© ğŸ•ª ğŸ•« ğŸ•¬ ğŸ– ğŸ–‚ ğŸ–ƒ ğŸ–„ ğŸ–… ğŸ–† ğŸ–‡ ğŸ–ˆ ğŸ–‰ ğŸ–Š ğŸ–‹ ğŸ–Œ ğŸ–
compression	ğŸ—œ
computer	ğŸ’» ğŸ–¥ ğŸ–¦ ğŸ–§ ğŸ–¨ ğŸ–© ğŸ–® ğŸ–¯ ğŸ–° ğŸ–± ğŸ–² ğŸ–³ ğŸ–´ ğŸ–µ ğŸ–¶ ğŸ–· ğŸ–¸ğŸ–³
walking	ğŸš¶
confetti	ğŸŠ
confounded	ğŸ˜–
confused	ğŸ˜•
construction	ğŸ— ğŸ‘· ğŸš§
control	ğŸ› ğŸ›‚
controller	ğŸ®
convenience	ğŸª
cookie	ğŸª
cooking	ğŸ³ ğŸ”ª
cooked	ğŸš
cool	ğŸ˜ ğŸ†’
copyright	Â© â„—
corn	ğŸŒ½
couch	ğŸ›‹
couple	ğŸ‘« ğŸ‘¬ ğŸ‘­ ğŸ’‘
cover	ğŸ“”
cow	ğŸ„ ğŸ®
cracker	ğŸ˜
crayon	ğŸ–
cream	ğŸ¦ ğŸ¨
credit,money,bank	ğŸ’³
crescent	ğŸŒ’ ğŸŒ˜ ğŸŒ™
crocodile	ğŸŠ
cross	â›‘ â›¨
crossbones	â˜  ğŸ•±
crossed	âš” ğŸŒ ğŸ”€
crossing,traffic	â›’ ğŸš¸
crown	ğŸ‘‘
cry	ğŸ˜¢ ğŸ˜­ ğŸ˜¿
tears	ğŸ˜¢ ğŸ˜­ ğŸ˜¿
sad	ğŸ˜¢ ğŸ˜­ ğŸ˜¿
crystal	ğŸ”®
cup,beverage	â›¾ ğŸµ ğŸ¶
curl	ğŸ“ƒ â¿ â°
currency,money,bank	ğŸ’± ğŸ’¹
curry	ğŸ›
custard	ğŸ®
customs	ğŸ›ƒ
cyclist	ğŸš´ ğŸšµ
cyclone	ğŸŒ€
dagger	ğŸ—¡
dancer	ğŸ’ƒ
danger	âš¡ï¸
dango	ğŸ¡
dark	ğŸŒ‘ ğŸ•¶
dash	ã€° ğŸ’¨
dazed	ğŸ˜³
deadpan	ğŸ˜
death	âš° â˜  ğŸ’€ ğŸ•± â›¼ âš±
deciduous	ğŸŒ³
decrease	ğŸ—›
dejected	ğŸ˜”
delicious	ğŸ˜‹
delivery	ğŸšš
department	ğŸ¬
departures	ğŸ›«
derelict	ğŸš
descending	ğŸ
desert	ğŸœ ğŸ

desktop	ğŸ–¥ ğŸ—”
devil	ğŸ‘¿
dialog	ğŸ’¬
diamond	â™¢ â™¦ï¸ ğŸƒ ğŸƒ‚ ğŸƒƒ ğŸƒ„ ğŸƒ… ğŸƒ† ğŸƒ‡ ğŸƒˆ ğŸƒ‰ ğŸƒŠ ğŸƒ‹ ğŸƒŒ ğŸƒ ğŸƒ ğŸ’ ğŸ’  ğŸ”¶ ğŸ”· ğŸ”¸ ğŸ”¹ ğŸ’
dice	âš€ âš âš‚ âšƒ âš„ âš… ğŸ²
die	âš€ âš âš‚ âšƒ âš„ âš… ğŸ²
diesel	ğŸ›²
dim	ğŸ”…
disabled	â›
disappointed	ğŸ˜ ğŸ˜¥
disc	ğŸ’½ ğŸ’¾ ğŸ’¿ ğŸ“€ ğŸ–¸
dish	ğŸ“¡
disk	ğŸ’¾ ğŸ–´
dividers	ğŸ—‚
division	â—
dizzy	ğŸŒ€ ğŸ’« ğŸ˜µ
doctor	â˜¤ ğŸ’‰ ğŸ’Š
document	ğŸ“ƒ ğŸ“„ ğŸ–¹ ğŸ–º ğŸ–» ğŸ—‹ ğŸ—
dog	ğŸ• ğŸ¶
doll	ğŸ
dollar	ğŸ’° ğŸ’² ğŸ’µ ğŸ’¸
dolphin	ğŸ¬
domino	ğŸ€° ğŸ€± ğŸ€² ğŸ€³ ğŸ€´ ğŸ€µ ğŸ€¶ ğŸ€· ğŸ€¸ ğŸ€¹ ğŸ€º ğŸ€» ğŸ€¼ ğŸ€½ ğŸ€¾ ğŸ€¿ ğŸ€ ğŸ ğŸ‚ ğŸƒ ğŸ„ ğŸ… ğŸ† ğŸ‡ ğŸˆ ğŸ‰ ğŸŠ ğŸ‹ ğŸŒ ğŸ ğŸ ğŸ ğŸ ğŸ‘ ğŸ’ ğŸ“ ğŸ” ğŸ• ğŸ– ğŸ— ğŸ˜ ğŸ™ ğŸš ğŸ› ğŸœ ğŸ ğŸ ğŸŸ ğŸ  ğŸ¡ ğŸ¢ ğŸ£ ğŸ¤ ğŸ¥ ğŸ¦ ğŸ§ ğŸ¨ ğŸ© ğŸª ğŸ« ğŸ¬ ğŸ­ ğŸ® ğŸ¯ ğŸ° ğŸ± ğŸ² ğŸ³ ğŸ´ ğŸµ ğŸ¶ ğŸ· ğŸ¸ ğŸ¹ ğŸº ğŸ» ğŸ¼ ğŸ½ ğŸ¾ ğŸ¿ ğŸ‚€ ğŸ‚ ğŸ‚‚ ğŸ‚ƒ ğŸ‚„ ğŸ‚… ğŸ‚† ğŸ‚‡ ğŸ‚ˆ ğŸ‚‰ ğŸ‚Š ğŸ‚‹ ğŸ‚Œ ğŸ‚ ğŸ‚ ğŸ‚ ğŸ‚ ğŸ‚‘ ğŸ‚’ ğŸ‚“
donut	ğŸ©
door	ğŸšª
doughnut	ğŸ©
dove,bird	ğŸ•Š
down	â¬ â· â˜Ÿ â›› â¤µï¸ â¬‡ï¸ ğŸ‘‡ ğŸ‘ ğŸ“‰ ğŸ“© ğŸ”» ğŸ”½ ğŸ–“ ğŸ–— ğŸ–Ÿ ğŸ–¡ ğŸ–£ ğŸ™¯
dragon, fairy tale	ğŸ‰ ğŸ²
draughts	â›€ â› â›‚ â›ƒ
dress	ğŸ‘—
drink	â˜•ï¸ â›¾ ğŸµ ğŸ¶ ğŸ· ğŸ¸ ğŸ¹ ğŸº ğŸ» ğŸ¼ ğŸš° ğŸš±
dromedary	ğŸª
drop	â˜”ï¸ ğŸŒ¢ ğŸ’§
drum	ğŸ›¢
dung	ğŸ’©
dusk	ğŸŒ† ğŸŒ‡
dvd	ğŸ’¿ ğŸ“€
ear	ğŸŒ½ ğŸŒ¾ ğŸ‘‚ ğŸ‘¯
earth	ğŸŒ ğŸŒ ğŸŒ
eggplant	ğŸ†
eight	ğŸ€— ğŸ€  ğŸ‚¨ ğŸ‚¸ ğŸƒˆ ğŸƒ˜ ğŸ± ğŸ•— ğŸ•£ 8ï¸âƒ£
eighteen	ğŸ”
eighth	â™ª â™«
eject	â
electric	ğŸ’¡ ğŸ”Œ ğŸ”¦ ğŸšƒ
elephant	ğŸ˜
eleven	ğŸ•š ğŸ•¦
emblem	ğŸ”±
empty	ğŸ—… ğŸ—† ğŸ—‡ ğŸ—‹ ğŸ—Œ ğŸ—
end	ğŸ”š
engine	ğŸš’ ğŸ›± ğŸš‚
entertainment	ğŸ ğŸŸ ğŸ  ğŸ¡ ğŸ¢ ğŸ£ ğŸ¤ ğŸ¥ ğŸ¦ ğŸ“½ ğŸ§ ğŸ¨ ğŸ© ğŸª ğŸ« ğŸ¬ ğŸ­
entry	â›”ï¸ â›œ â›  â›¡ ğŸš«
envelope	âœ‰ï¸ ğŸ“¨ ğŸ“© ğŸ–‚ ğŸ–ƒ ğŸ–„ ğŸ–… ğŸ–†
eruption	ğŸŒ‹
euro	ğŸ’¶
europe	ğŸŒ
european	ğŸ¤ ğŸ°
evening	ğŸŒ†
evergreen	ğŸŒ²
exchange	ğŸ’±
excited	ğŸ’– ğŸ’—
exclamation	â€¼ï¸ â‰ï¸ â• â—ï¸ â¢ â£
expressionless	ğŸ˜‘
middle finger	ğŸ–•
extraterrestrial	ğŸ‘½ ğŸ‘¾
eye	ğŸ¯ ğŸ‘ ğŸ˜œğŸ˜ŠğŸ˜ ğŸ˜„ ğŸ˜Š ğŸ˜ ğŸ˜™ ğŸ˜š ğŸ˜ ğŸ˜¸ ğŸ˜» ğŸ˜½ ğŸ‘€
eyewear,glasses	ğŸ‘“
face	â˜¹ â˜ºï¸ â˜» âš€ âš âš‚ âšƒ âš„ âš… ğŸŒš ğŸŒ› ğŸŒœ ğŸŒ ğŸŒ ğŸŒ¬ ğŸ­ ğŸ­ ğŸ® ğŸ¯ ğŸ° ğŸ± ğŸ² ğŸ´ ğŸµ ğŸ¶ ğŸ· ğŸ¸ ğŸ¹ ğŸº ğŸ» ğŸ¼ ğŸ‘€ ğŸ’† ğŸ• ğŸ•‘ ğŸ•’ ğŸ•“ ğŸ•” ğŸ•• ğŸ•– ğŸ•— ğŸ•˜ ğŸ•™ ğŸ•š ğŸ•› ğŸ•œ ğŸ• ğŸ• ğŸ•Ÿ ğŸ•  ğŸ•¡ ğŸ•¢ ğŸ•£ ğŸ•¤ ğŸ•¥ ğŸ•¦ ğŸ•§ ğŸ˜€ ğŸ˜ ğŸ˜‚ ğŸ˜ƒ ğŸ˜„ ğŸ˜… ğŸ˜† ğŸ˜‡ ğŸ˜ˆ ğŸ˜‰ ğŸ˜Š ğŸ˜‹ ğŸ˜Œ ğŸ˜ ğŸ˜ ğŸ˜ ğŸ˜ ğŸ˜‘ ğŸ˜’ ğŸ˜“ ğŸ˜” ğŸ˜• ğŸ˜– ğŸ˜— ğŸ˜˜ ğŸ˜™ ğŸ˜š ğŸ˜› ğŸ˜œ ğŸ˜ ğŸ˜ ğŸ˜Ÿ ğŸ˜  ğŸ˜¡ ğŸ˜¢ ğŸ˜£ ğŸ˜¤ ğŸ˜¥ ğŸ˜¦ ğŸ˜§ ğŸ˜¨ ğŸ˜© ğŸ˜ª ğŸ˜« ğŸ˜¬ ğŸ˜­ ğŸ˜® ğŸ˜¯ ğŸ˜° ğŸ˜± ğŸ˜² ğŸ˜³ ğŸ˜´ ğŸ˜µ ğŸ˜¶ ğŸ˜· ğŸ˜¸ ğŸ˜¹ ğŸ˜º ğŸ˜» ğŸ˜¼ ğŸ˜½ ğŸ˜¾ ğŸ˜¿ ğŸ™€ ğŸ™ ğŸ™‚ ğŸ™… ğŸ™† ğŸ™ ã€ 
face	ğŸ­ ğŸ® ğŸ¯ ğŸ° ğŸ± ğŸ² ğŸ³ ğŸ´ ğŸµ ğŸ¶ ğŸ· ğŸ¸ ğŸ¹ ğŸº ğŸ» ğŸ¼ ğŸ½
factory	ğŸ­
fairy tale	ğŸ‘¸ ğŸ‘¹ ğŸ‘º ğŸ‘» ğŸ‘¼ ğŸ‘½ ğŸ‘¾ ğŸ‘¿ ğŸ’€
fall	ğŸ€¨
falling	ğŸŒ  ğŸ‚ ğŸ
family	ğŸ‘ª
fast	â©
father	ğŸ… ğŸ‘ª
fax	ğŸ“  ğŸ–·
fear	ğŸ˜¨ ğŸ˜±
fearful	ğŸ˜¨ ğŸ˜±
scared	ğŸ˜¨ ğŸ˜±
ferris	ğŸ¡
ferry	â›´
festival	ğŸ
file	ğŸ“ ğŸ“‚ ğŸ—ƒ ğŸ—„
film, movie, cinema,entertainment	ğŸ ğŸ¦ ğŸ“½
finger	â˜š â˜› â˜œ â˜ï¸ â˜ â˜Ÿ ğŸ‘† ğŸ‘‡ ğŸ‘ˆ ğŸ‘‰ ğŸ– ğŸ–‘ ğŸ–• ğŸ–– ğŸ–— ğŸ–˜ ğŸ–™ ğŸ–š ğŸ–› ğŸ–œ ğŸ– ğŸ– ğŸ–Ÿ ğŸ–  ğŸ–¡ ğŸ–¢ ğŸ–£
spock, vulcan	ğŸ––
fire	ğŸ”¥ ğŸš’ ğŸ›±
fireworks	ğŸ† ğŸ‡
fish	ğŸ¥ ğŸ£ ğŸŸ ğŸ 
fist	âœŠ ğŸ‘Š
five	ğŸ€” ğŸ€ ğŸ‚¥ ğŸ‚µ ğŸƒ… ğŸƒ• ğŸ•” ğŸ•  5ï¸âƒ£
flag	âš âš‘ â›³ï¸ â›¿ ğŸŒ ğŸ ğŸ³ ğŸ´ ğŸ“ª ğŸ“« ğŸ“¬ ğŸ“­ ğŸš©
flame	ğŸ”¥
flash	ğŸ“¸
flashlight	ğŸ”¦
flat	â™­
fleur-de-lis	âšœ
flex	ğŸ’ª
floppy	ğŸ’¾
flower	â˜™ âš˜ â¦ â§ ğŸŒ· ğŸŒ¸ ğŸŒ¹ ğŸŒº ğŸŒ» ğŸŒ¼ ğŸ• ğŸ´ ğŸ’ ğŸ’®
flushed	ğŸ˜³
flutter	ğŸƒ
fly	ğŸ’¸ ğŸ•Š ğŸ–…
fog	ğŸŒ ğŸŒ«
folded,hand	ğŸ™
folder	ğŸ“ ğŸ“‚ ğŸ–¿ ğŸ—€ ğŸ—
font	ğŸ—š ğŸ—›
food	 ğŸ… ğŸ† ğŸ‡ ğŸˆ ğŸ‰ ğŸŠ ğŸ‹ ğŸŒ ğŸ ğŸ ğŸ ğŸ ğŸ‘ ğŸ’ ğŸ“ ğŸ” ğŸ• ğŸ– ğŸ— ğŸ˜ ğŸ™ ğŸš ğŸ› ğŸœ ğŸ ğŸ ğŸŸ ğŸ  ğŸ¡ ğŸ¢ ğŸ£ ğŸ¤ ğŸ¥ ğŸ¦ ğŸ§ ğŸ¨ ğŸ© ğŸª ğŸ« ğŸ¬ ğŸ­ ğŸ® ğŸ¯ ğŸ° ğŸ± ğŸ² ğŸ³ ğŸ´ ğŸ½
fool	ğŸƒ 
football	ğŸˆ ğŸ‰
footprint	ğŸ‘£
prohibited	â›”ï¸ ğŸ“µ ğŸ”• ğŸ” ğŸ•² ğŸš« ğŸš­ ğŸš¯ ğŸš± ğŸš³ ğŸš·ğŸ™… ğŸ›‡â›”ï¸ ğŸ“µ ğŸ”• ğŸ” ğŸ•² ğŸ™… ğŸ™ˆ ğŸ™‰ ğŸ™Š ğŸš« ğŸš­ ğŸš¯ ğŸš± ğŸš³ ğŸš·
forbidden	â›”ï¸ ğŸ“µ ğŸ”• ğŸ” ğŸ•² ğŸš« ğŸš­ ğŸš¯ ğŸš± ğŸš³ ğŸš·ğŸ™… ğŸ›‡ â›”ï¸ ğŸ“µ ğŸ”• ğŸ” ğŸ•² ğŸ™… ğŸ™ˆ ğŸ™‰ ğŸ™Š ğŸš« ğŸš­ ğŸš¯ ğŸš± ğŸš³ ğŸš·
not	â›”ï¸ ğŸ“µ ğŸ”• ğŸ” ğŸ•² ğŸš« ğŸš­ ğŸš¯ ğŸš± ğŸš³ ğŸš·ğŸ™… ğŸ›‡ â›”ï¸ ğŸ“µ ğŸ”• ğŸ” ğŸ•² ğŸ™… ğŸ™ˆ ğŸ™‰ ğŸ™Š ğŸš« ğŸš­ ğŸš¯ ğŸš± ğŸš³ ğŸš·
no	â›”ï¸ ğŸ“µ ğŸ”• ğŸ” ğŸ•² ğŸš« ğŸš­ ğŸš¯ ğŸš± ğŸš³ ğŸš·ğŸ™… ğŸ›‡ â›”ï¸ ğŸ“µ ğŸ”• ğŸ” ğŸ•² ğŸ™… ğŸ™ˆ ğŸ™‰ ğŸ™Š ğŸš« ğŸš­ ğŸš¯ ğŸš± ğŸš³ ğŸš·
fork	ğŸ´ ğŸ½
fortune	ğŸ”® ğŸ”¯
forward	â©
fountain	â›²ï¸ ğŸ–‹
four	ğŸ€“ ğŸ€œ ğŸ‚¤ ğŸ‚´ ğŸƒ„ ğŸƒ” ğŸ€ ğŸ•“ ğŸ•Ÿ 4ï¸âƒ£
frame	ğŸ–¼ ğŸ–½ ğŸ–¾
frames	ğŸ
free	ğŸ†“
french	ğŸŸ
fried,tempura	ğŸ¤
fries	ğŸŸ
frog	ğŸ¸
frowning	â˜¹ ğŸ˜¦ ğŸ™ ğŸ™
fruit	ğŸ‡ ğŸˆ ğŸ‰ ğŸŠ ğŸ‹ ğŸŒ ğŸ ğŸ ğŸ ğŸ ğŸ‘
fried	ğŸ³
fuel	â›½ï¸
fuji	ğŸ—»
full	ğŸŒ• ğŸŒ ğŸ’¯
funeral	âš±
game	ğŸ® ğŸ¯ ğŸ° ğŸ± ğŸ² ğŸ³ ğŸ´ ğŸ•¹
garden	ğŸ¡
gas	â›½ï¸
gear	âš™
gem	ğŸ’
gemini	â™Šï¸
gesture	ğŸ™… ğŸ™† ğŸ™‡ ğŸ™ˆ ğŸ™‰ ğŸ™Š ğŸ™‹ ğŸ™Œ ğŸ™ ğŸ™ ğŸ™
ghost	ğŸ‘»
gibbous	ğŸŒ” ğŸŒ–
gift	ğŸ
girl	ğŸ‘§ ğŸ‘¯ ğŸ›Š
glass	ğŸ· ğŸ¸ ğŸ” ğŸ”
glasses, eye	ğŸ‘“ ğŸ•¶ ğŸ˜
glittery	ğŸŒŸ
globe,world,earth	ğŸŒ ğŸŒ ğŸŒ ğŸŒ
glow	ğŸŒŸ
goat	ğŸ
goblin	ğŸ‘º
golf	â›³ ğŸŒ
gondola	ğŸš  ğŸš¡
graduation	ğŸ“
grape	ğŸ‡
graph	ğŸ’¹ ğŸ“ˆ ğŸ“‰ ğŸ“Š ğŸ— 
graveyard	â›¼
green	ğŸ ğŸ’š ğŸ“— ğŸ”°
grimace	ğŸ˜¬
grin	ğŸ˜€ ğŸ˜ ğŸ˜¸
growing	ğŸ’—
gua pi mao,hat	ğŸ‘²
guard	ğŸ’‚
guitar	ğŸ¸
gun	ğŸ”«
haircut	ğŸ’‡
halo	ğŸ˜‡
hamburger	ğŸ”
hammer	âš’ ğŸ”¨ ğŸ› 
hamster	ğŸ¹
hand	â˜š â˜› â˜œ â˜ï¸ â˜ â˜Ÿ âœŠ âœ‹ âœŒï¸ âœ ğŸ‘† ğŸ‘‡ ğŸ‘ˆ ğŸ‘‰ ğŸ‘Š ğŸ‘‹ ğŸ‘Œ ğŸ‘ ğŸ‘ ğŸ‘ ğŸ‘ ğŸ– ğŸ– ğŸ– ğŸ–‘ ğŸ–’ ğŸ–“ ğŸ–” ğŸ–• ğŸ–– ğŸ–— ğŸ–˜ ğŸ–™ ğŸ–š ğŸ–› ğŸ–œ ğŸ– ğŸ– ğŸ–Ÿ ğŸ–  ğŸ–¡ ğŸ–¢ ğŸ–£ ğŸ™‹ ğŸ™Œ ğŸ™
ğŸ‘«
ğŸ‘¬
ğŸ‘­
ğŸ‘
ğŸ‘
ğŸ™Œ
ğŸ™
emotion	ğŸ’˜
ğŸ’“
ğŸ’”
ğŸ’•
ğŸ’–
ğŸ’—
ğŸ’™
ğŸ’š
ğŸ’›
ğŸ’œ
ğŸ’
ğŸ’
ğŸ’¤
ğŸ’¢
ğŸ’£
ğŸ’¥
ğŸ’¦
ğŸ’¨
ğŸ’«
ğŸ’ 
handbag	ğŸ‘œ
happy	ğŸ™‹
hard	ğŸ–´
hat	ğŸ© ğŸ‘’
hatching	ğŸ£
head	ğŸ—£
headphone	ğŸ§
headstone	â›¼
hear	ğŸ™‰
heart	â˜™ â™¡ â™¥ï¸ â£ â¤ï¸ â¥ â¦ â§ ğŸ‚± ğŸ‚² ğŸ‚³ ğŸ‚´ ğŸ‚µ ğŸ‚¶ ğŸ‚· ğŸ‚¸ ğŸ‚¹ ğŸ‚º ğŸ‚» ğŸ‚¼ ğŸ‚½ ğŸ‚¾ ğŸ” ğŸ’‹ ğŸ’Œ ğŸ’‘ ğŸ’“ ğŸ’” ğŸ’• ğŸ’– ğŸ’— ğŸ’˜ ğŸ’™ ğŸ’š ğŸ’› ğŸ’œ ğŸ’ ğŸ’ ğŸ’Ÿ ğŸ˜ ğŸ˜˜ ğŸ˜»
heels	ğŸ‘ 
helicopter	ğŸš
helm	âˆ 
helmet	â›‘
help	ğŸ’
herb	ğŸŒ¿
hermes	âšš
hibiscus	ğŸŒº
hit	ğŸ¯
hold	ğŸ‘« ğŸ‘¬ ğŸ‘­
hole	â›³ï¸ ğŸ•³
home	ğŸ¡ ğŸ 
honey	ğŸ¯
honeybee	ğŸ
honeypot	ğŸ¯
hoop	ğŸ€
hooray	ğŸ™Œ
horn	ğŸ“¯
horns	ğŸ˜ˆ
horrible	ğŸ˜
horse	ğŸ  ğŸ‡ ğŸ ğŸ´
hospital	ğŸ¥
hot	â˜•ï¸ â™¨ï¸ ğŸŒ¶
hotel	ğŸ¨ ğŸ© ğŸ›‹ ğŸ›Œ ğŸ› ğŸ› ğŸ›
hourglass	âŒ›ï¸ â³
house	ğŸ˜ ğŸš ğŸ  ğŸ¡
hump	ğŸª ğŸ«
hundred	ğŸ’¯
hushed	ğŸ˜¯
stunned	ğŸ˜¯
surprised	ğŸ˜¯   
ice	â›¸ ğŸ¦ ğŸ§
i	â„¹  ğŸ›ˆ
id	ğŸ†”
idea	ğŸ’¡
identity	ğŸ†”
imp	ğŸ‘¿
inbox	ğŸ“¥
incoming	ğŸ“¨
increase	ğŸ—š
index	â˜š â˜› â˜œ â˜ï¸ â˜ â˜Ÿ ğŸ‘† ğŸ‘‡ ğŸ‘ˆ ğŸ‘‰ ğŸ“‡ ğŸ–— ğŸ–˜ ğŸ–™ ğŸ–š ğŸ–› ğŸ–œ ğŸ– ğŸ– ğŸ–Ÿ ğŸ–  ğŸ–¡ ğŸ–¢ ğŸ–£ ğŸ—‚
information	ğŸ’ ğŸ›ˆ â„¹ï¸
ink,nib	ğŸ”
input	ğŸ”  ğŸ”¡ ğŸ”¢ ğŸ”£ ğŸ”¤
inside	ğŸ’ 
instrument	ğŸ¸
ironic	ğŸ˜¼
island	ğŸ
jack	ğŸ‚« ğŸ‚» ğŸƒ‹ ğŸƒ› ğŸƒ
wired	ğŸ˜
japan	ğŸ—¾
japanese	ğŸŒ ğŸ ğŸ ğŸ´ ğŸ£ ğŸ¯ ğŸ‘¹ ğŸ‘º ğŸ”°ğŸ‹ğŸ¡ğŸ®ğŸ™
ğŸ¡
ğŸ®ğŸˆ
ğŸˆ‚
ğŸˆ¹
ğŸ‰
ğŸˆ¯
ğŸˆ·
ğŸˆ¶
ğŸˆš
ğŸˆ²
chinese	ğŸ‰‘
ğŸˆ´
ğŸˆº
ğŸˆµ
ğŸˆ¸
ğŸˆ³
jeans	ğŸ‘–
jewel	ğŸ’
jockey,racehorse	ğŸ‡
joke	ğŸ˜œ
joker	ğŸ€ª ğŸ‚¿ ğŸƒ ğŸƒŸ
joy	ğŸ˜‚ ğŸ˜¹
joystick	ğŸ•¹
kebab	ğŸ¢
key	âš¿ ğŸ” ğŸ”‘ ğŸ—
keyboard	âŒ¨ ğŸ˜ ğŸ¹ ğŸ–¦ ğŸ–®
keycap	0ï¸âƒ£ 1ï¸âƒ£ 2ï¸âƒ£ 3ï¸âƒ£ 4ï¸âƒ£ 5ï¸âƒ£ 6ï¸âƒ£ 7ï¸âƒ£ 8ï¸âƒ£ 9ï¸âƒ£
kimono	ğŸ‘˜
king	â™” â™š â› â›ƒ ğŸ‚® ğŸ‚¾ ğŸƒ ğŸƒ ğŸ‘‘
kiss	ğŸ’‹ ğŸ’ ğŸ˜— ğŸ˜˜ ğŸ˜™ ğŸ˜š ğŸ˜½
knife	ğŸ´ ğŸ½ ğŸ”ª ğŸ—¡
knight	â™˜ â™ ğŸ‚¬ ğŸ‚¼ ğŸƒŒ ğŸƒœ
knobs	ğŸ›
koala	ğŸ¨
label	ğŸ·
landing	ğŸ›¬
lamp	ğŸ›‹
landscape	ğŸŒ†
lane,traffic	â›’ â›˜ â›™
lantern	ğŸƒ ğŸ®
lavatory	ğŸš» ğŸš¾
leaf	ğŸŒ¿ ğŸ€ ğŸ ğŸ‚ ğŸƒ ğŸ”°
ledger	ğŸ“’
leg	ğŸ—
lemon	ğŸ‹
leo	â™Œï¸
leopard	ğŸ†
letter,mail	ğŸ’Œ ğŸ“¤ ğŸ“¥ ğŸ“§ ğŸ“¨ ğŸ“© ğŸ–„
email,e-mail	ğŸ“§ğŸ“¨ ğŸ“© ğŸ–„
letters	ğŸ”  ğŸ”¡ ğŸ”¤
level	ğŸš
liberty	ğŸ—½
libra	â™ï¸
lifter	ğŸ‹
light	ğŸ’¡ ğŸ”¦ ğŸš¥ ğŸš¦ ğŸš¨
lightning	ğŸŒ© ğŸ–„ ğŸ—± ğŸ—²
link 	ğŸ”— ğŸ–‡
lips	ğŸ’‹ ğŸ—¢
lipstick	ğŸ’„
litter	ğŸš® ğŸš¯
litterbox	ğŸš®
loaf	ğŸ
lock	ğŸ” ğŸ” ğŸ”’ ğŸ”“
locker	ğŸ›…
locomotive	ğŸš‚ ğŸ›²
lollipop	ğŸ­
loop	â° â¿
lorry	ğŸš›
loud	ğŸ”ŠğŸ•¬ğŸ“¢ ğŸ•ª
loudspeaker	ğŸ“¢
love	ğŸ© ğŸ’Œ ğŸ’• ğŸ˜»ğŸ˜ ğŸ’‘
low	ğŸ”… ğŸ”‰ ğŸ•¨ 
lowercase	ğŸ”¡
luggage	ğŸ›…
mad	ğŸ˜ 
magnifying,tool	ğŸ” ğŸ”
left luggage	ğŸ›…
mahjong	ğŸ€€ ğŸ€ ğŸ€‚ ğŸ€ƒ ğŸ€„ï¸ ğŸ€… ğŸ€† ğŸ€‡ ğŸ€ˆ ğŸ€‰ ğŸ€Š ğŸ€‹ ğŸ€Œ ğŸ€ ğŸ€ ğŸ€ ğŸ€ ğŸ€‘ ğŸ€’ ğŸ€“ ğŸ€” ğŸ€• ğŸ€– ğŸ€— ğŸ€˜ ğŸ€™ ğŸ€š ğŸ€› ğŸ€œ ğŸ€ ğŸ€ ğŸ€Ÿ ğŸ€  ğŸ€¡ ğŸ€¢ ğŸ€£ ğŸ€¤ ğŸ€¥ ğŸ€¦ ğŸ€§ ğŸ€¨ ğŸ€© ğŸ€ª ğŸ€«
mail	ğŸ’Œ ğŸ“¤ ğŸ“¥ ğŸ“§ ğŸ“¨ ğŸ“© ğŸ–„ğŸ“ª
ğŸ“«
ğŸ“¬
ğŸ“­ğŸ“®
mailbox	ğŸ“ª ğŸ“« ğŸ“¬ ğŸ“­ğŸ“®
postbox	ğŸ“ª ğŸ“« ğŸ“¬ ğŸ“­ğŸ“®
outlined	â˜º
ğŸ”³
â”
â•
latin	ğŸ” 
ğŸ”¡
ğŸ”¤
help	ğŸ†˜
lightning	âš¡
cosmetics	ğŸ’…
lavatory, restroom	ğŸš¾ ğŸš»
maize	ğŸŒ½
man	 ğŸ‘ ğŸ‘¨ ğŸ‘« ğŸ‘² ğŸ‘³ ğŸ‘´ ğŸ•´
manicure	ğŸ’…
map	ğŸ—º ğŸ—¾
maple	ğŸ
marker	ğŸ“‘
market	ğŸ’¹
mask	ğŸ­ ğŸ˜·
massage	ğŸ’†
maximize	ğŸ—–
maze	ğŸŒ½
meat	ğŸ–
medal	ğŸ– ğŸ…
medicine	â˜¤ ğŸ’‰ ğŸ’Š
megaphone	ğŸ“£
melon	ğŸˆ
memo	ğŸ“
men	ğŸ‘¬ ğŸš¹
merge	â›˜ â›™
meridians	ğŸŒ
metro	ğŸš‡
mic	ğŸ™ ğŸ¤
microphone	ğŸ™ ğŸ¤
microscope	ğŸ”¬
military	ğŸ– ğŸ›¦
milk	ğŸ¼
milky way	ğŸŒŒ
minibus	ğŸš
minimize	ğŸ—•
mobile	ğŸ“± ğŸ“² ğŸ“³ ğŸ“´ ğŸ“µ ğŸ“¶ ğŸ–
mode	ğŸ“³
money	ğŸ’° ğŸ’´ ğŸ’µ ğŸ’¶ ğŸ’· ğŸ’¸ğŸ’±ğŸ’²
currency	ğŸ’´ ğŸ’µ ğŸ’¶ ğŸ’· ğŸ’±ğŸ’²
monkey	ğŸ’ ğŸµ ğŸ™ˆ ğŸ™‰ ğŸ™Š
monorail	ğŸš
monster	ğŸ‘¾
mood	ğŸ—° ğŸ—± ğŸ—²
moon	â˜½ â˜¾ ğŸŒ‘ ğŸŒ’ ğŸŒ“ ğŸŒ” ğŸŒ• ğŸŒ– ğŸŒ— ğŸŒ˜ ğŸŒ™ ğŸŒš ğŸŒ› ğŸŒœ ğŸŒ ğŸ‘
morning	ğŸŒ„ ğŸŒ…
mother	ğŸ‘ª
motorboat	ğŸ›¥
motorcycle	ğŸ
motorway,highway,road	ğŸ›£
mountain	â›° ğŸŒ„ ğŸ” ğŸ—» ğŸš ğŸš  ğŸšµ

mouse	ğŸ ğŸ­ ğŸ–¦ ğŸ–¯ ğŸ–° ğŸ–±
mouth	ğŸ‘„ğŸ˜ƒ
ğŸ˜„
ğŸ˜†
ğŸ˜¦
ğŸ˜®
ğŸ˜°
ğŸ˜¶
ğŸ˜º
movie	ğŸ¥ ğŸ¦ğŸ¬
moyai	ğŸ—¿
mug	ğŸº ğŸ»
muscle	ğŸ’ª
mushroom	ğŸ„
music	â™© â™ª â™« â™¬ â™­ â™® â™¯ ğŸ˜ ğŸ™ ğŸš ğŸ› ğŸœ ğŸ ğŸµ ğŸ¶ ğŸ· ğŸ¸ ğŸ¹ ğŸº ğŸ» ğŸ¼
nail	ğŸ’…
name	ğŸ“›
national park	ğŸ
natural sign,sign	â™®
necktie	ğŸ‘”
needle	ğŸ’‰
nervous	ğŸ’—
network	ğŸ–§
neutral	ğŸ˜
new	ğŸ†•
news	ğŸ“° ğŸ—
newspaper	ğŸ“° ğŸ—
nib,pen	âœ‘ âœ’ï¸
night	ğŸŒƒ ğŸŒ‰
nine	ğŸ€˜ ğŸ€¡ ğŸ‚© ğŸ‚¹ ğŸƒ‰ ğŸƒ™ ğŸ•˜ ğŸ•¤ 9ï¸âƒ£

noodle	ğŸœ
northeast	â†—ï¸ ğŸ›ª
northwest	â†–ï¸
nose	ğŸ½ ğŸ‘ƒ
note	â™© â™ª â™« â™¬ ğŸœ ğŸ ğŸµ ğŸ¶ ğŸ’´ ğŸ’µ ğŸ’¶ ğŸ’· ğŸ’¸ ğŸ—… ğŸ—† ğŸ—‡ ğŸ—ˆ ğŸ—‰ ğŸ—Š ğŸ—’
notebook	ğŸ“’ ğŸ““ ğŸ“”
note	ğŸ¶
number	ğŸ”¢
nut	ğŸ”©
ocean	ğŸŒŠ
octopus	ğŸ™
off	ğŸ“´
office	ğŸ¢ ğŸ£ ğŸ¤ ğŸ’º ğŸ’» ğŸ’¼ ğŸ’½ ğŸ’¾ ğŸ’¿ ğŸ“€ ğŸ“ ğŸ“‚ ğŸ“ƒ ğŸ“„ ğŸ“… ğŸ“† ğŸ“‡ ğŸ“ˆ ğŸ“‰ ğŸ“Š ğŸ“‹ ğŸ“Œ ğŸ“ ğŸ“ ğŸ“ ğŸ“ ğŸ“‘ ğŸ“’ ğŸ““ ğŸ“” ğŸ“• ğŸ“– ğŸ“— ğŸ“˜ ğŸ“™ ğŸ“š ğŸ“› ğŸ“œ ğŸ–¹ ğŸ–º ğŸ–» ğŸ–¼ ğŸ–½ ğŸ–¾
officer	ğŸ‘®
ogre	ğŸ‘¹
oh	ğŸ™€
oil	ğŸ›¢
ok	ğŸ‘Œ ğŸ– ğŸ†— ğŸ™†
old	ğŸ‘´ ğŸ‘µ
oncoming	ğŸš ğŸš” ğŸš– ğŸš˜ ğŸ›±
1,one	ğŸ€ ğŸ€™ ğŸ• ğŸ•œ
open	ğŸ‘ ğŸ“‚ ğŸ“– ğŸ“¬ ğŸ“­ ğŸ”“ ğŸ— ğŸ˜ƒ ğŸ˜„ ğŸ˜… ğŸ˜† ğŸ˜¦ ğŸ˜® ğŸ˜° ğŸ˜º
ophiuchus	â›
optical	ğŸ’¿ ğŸ–¸ ğŸ’½ ğŸ“€
orange	ğŸŠ ğŸ“™ ğŸ”¶ ğŸ”¸
orchid	ğŸ€£
outbox	ğŸ“¤
space	ğŸ›° ğŸš€ ğŸ‘½ ğŸ‘¾ ğŸŒŒ ğŸŒ  â˜½ â˜¾ ğŸŒ‘ ğŸŒ’ ğŸŒ“ ğŸŒ” ğŸŒ• ğŸŒ– ğŸŒ— ğŸŒ˜ ğŸŒ™ â˜„ 
outgoing	ğŸ“©
overlap	ğŸ——
ox	ğŸ‚
package	ğŸ“¦
pad	ğŸ—‡ ğŸ—Š ğŸ—’ ğŸ—“
page	ğŸ“ƒ ğŸ“„ ğŸ—† ğŸ—‰ ğŸ—Œ ğŸ— ğŸ— ğŸ— ğŸ—Ÿ
pager	ğŸ“Ÿ
painting,art	ğŸ¨ ğŸ–¼
paintbrush,painting	ğŸ–Œ
palette	ğŸ¨
palm	â¸™ ğŸŒ´
pan	ğŸ³
panda	ğŸ¼
pants	ğŸ‘–
paper	â™¾ ğŸ“œ ğŸ“° ğŸ—† ğŸ—‰ ğŸ—Œ ğŸ— ğŸ— ğŸ—Ÿ
paperclip	ğŸ“ ğŸ–‡
parcel	ğŸ“¦
park	ğŸ
parking	ğŸ…¿ï¸
part	ã€½ï¸
party	ğŸ‰
passport	ğŸ›‚
password	ğŸ”‘
pasta	ğŸ
patrol	ğŸš“
paw	ğŸ¾
pawn	â™™ â™Ÿ
pc	ğŸ’»
peace	â˜® ğŸ•Š
peach	ğŸ‘
pear	ğŸ
pedestrian	ğŸš¶ ğŸš· ğŸš¸
pen	ğŸ” ğŸ–† ğŸ–Š ğŸ–‹
pencil	âœ âœï¸ âœ ğŸ–‰
penguin	ğŸ§
pennant	ğŸ± ğŸ²
pensive	ğŸ˜”
person	â›¹ ğŸ‘¤ ğŸ‘¥ ğŸ‘± ğŸ’ ğŸ™‡ ğŸ™‹ ğŸ™Œ ğŸ™ ğŸ™ ğŸ™ğŸ‘¦
ğŸ‘§
ğŸ‘¨
ğŸ‘©
ğŸ‘®
ğŸ‘±
ğŸ‘²
ğŸ‘³
ğŸ‘´
ğŸ‘µ
ğŸ‘¶
ğŸ‘·
ğŸ‘¸
ğŸ’‚
ğŸ’ƒ
ğŸ’
ğŸ’‘
ğŸ‘¯
ğŸ‘°
ğŸ™‡
ğŸ™‹
ğŸ™
ğŸ™
ğŸ‘ª
ğŸ‘«
ğŸ‘¬
ğŸ‘­
pepper	ğŸŒ¶
performing,theater,theatre	ğŸ­
permanent,acid-free,symbol	â™¾
persevere	ğŸ˜£
personal	ğŸ’» ğŸ–³
phone	ğŸ“ ğŸ“± ğŸ“² ğŸ“³ ğŸ“´ ğŸ“µ ğŸ–ğŸ“¶ğŸ“¶
cosmetics, makeup	ğŸ’„
piano	ğŸ¹
pick	âš’ â›
picture	ğŸ–º ğŸ–» ğŸ–¼
pig	ğŸ– ğŸ· ğŸ½
pill	ğŸ’Š
pin	ğŸ“Œ ğŸ“ ğŸ–ˆ
pine	ğŸ
pineapple	ğŸ
piracy,copyright	ğŸ•²
pisces	â™“ï¸
pistol	ğŸ”«
pizza	ğŸ•
plant	ğŸ â¸™ â˜˜ ğŸŒ° ğŸŒ± ğŸŒ² ğŸŒ³ ğŸŒ´ ğŸŒµ ğŸŒ¶ ğŸŒ· ğŸŒ¸ ğŸŒ¹ ğŸŒº ğŸŒ» ğŸŒ¼ ğŸŒ½ ğŸŒ¾ ğŸŒ¿ ğŸ€ ğŸ ğŸ‚ ğŸƒ ğŸ„ ğŸ… ğŸ† ğŸ‡ ğŸˆ ğŸ‰ ğŸŠ ğŸ‹ ğŸŒ ğŸ ğŸ ğŸ ğŸ ğŸ‘ ğŸ’ ğŸ“ ğŸ•
plate	ğŸ½
playing	ğŸ‚  ğŸ‚¡ ğŸ‚¢ ğŸ‚£ ğŸ‚¤ ğŸ‚¥ ğŸ‚¦ ğŸ‚§ ğŸ‚¨ ğŸ‚© ğŸ‚ª ğŸ‚« ğŸ‚¬ ğŸ‚­ ğŸ‚® ğŸ‚± ğŸ‚² ğŸ‚³ ğŸ‚´ ğŸ‚µ ğŸ‚¶ ğŸ‚· ğŸ‚¸ ğŸ‚¹ ğŸ‚º ğŸ‚» ğŸ‚¼ ğŸ‚½ ğŸ‚¾ ğŸ‚¿ ğŸƒ ğŸƒ‚ ğŸƒƒ ğŸƒ„ ğŸƒ… ğŸƒ† ğŸƒ‡ ğŸƒˆ ğŸƒ‰ ğŸƒŠ ğŸƒ‹ ğŸƒŒ ğŸƒ ğŸƒ ğŸƒ ğŸƒ‘ ğŸƒ’ ğŸƒ“ ğŸƒ” ğŸƒ• ğŸƒ– ğŸƒ— ğŸƒ˜ ğŸƒ™ ğŸƒš ğŸƒ› ğŸƒœ ğŸƒ ğŸƒ ğŸƒŸ ğŸƒ  ğŸƒ¡ ğŸƒ¢ ğŸƒ£ ğŸƒ¤ ğŸƒ¥ ğŸƒ¦ ğŸƒ§ ğŸƒ¨ ğŸƒ© ğŸƒª ğŸƒ« ğŸƒ¬ ğŸƒ­ ğŸƒ® ğŸƒ¯ ğŸƒ° ğŸƒ± ğŸƒ² ğŸƒ³ ğŸƒ´ ğŸƒµ ğŸ´
plug	ğŸ”Œ
plum	ğŸ€¢
point	â˜š â˜› â˜œ â˜ï¸ â˜ â˜Ÿ ğŸ‘† ğŸ‘‡ ğŸ‘ˆ ğŸ‘‰ ğŸ–— ğŸ–˜ ğŸ–™ ğŸ–š ğŸ–› ğŸ–œ ğŸ– ğŸ– ğŸ–Ÿ ğŸ–  ğŸ–¡ ğŸ–¢ ğŸ–£
pole	 ğŸ’ˆ
police	ğŸ‘® ğŸš“ ğŸš” ğŸš¨
polish	ğŸ’…
poo	ğŸ’©
poodle	ğŸ©
poop	ğŸ’©
popper	ğŸ‰
portable	ğŸ“¾
post	ğŸ£ ğŸ¤ ğŸš©
postal	ğŸ“¯ ã€ 
postbox	ğŸ“®
pot	ğŸ¯ ğŸ²
potable	ğŸš° ğŸš±
potato	ğŸ 
pouch	ğŸ‘
poultry,bone	ğŸ—
pound	ğŸ’·
pouting	ğŸ˜¡ ğŸ˜¾ ğŸ™
prawn	ğŸ¤
pray,ask,please,thanks	ğŸ™
present	ğŸ
princess	ğŸ‘¸
print	ğŸ¾ ğŸ‘£
printer	ğŸ–¨ ğŸ–¶
privacy	ğŸ”
prize	ğŸ†

projector	ğŸ“½
pudding	ğŸ®
pulsating	ğŸ’“
pump	â›½ï¸
purple	ğŸ’œ
purse	ğŸ‘›
pushpin	ğŸ“Œ ğŸ“ ğŸ–ˆ
quarter	â˜½ â˜¾ â™© ğŸŒ“ ğŸŒ— ğŸŒ› ğŸŒœ
queen	â™• â™› ğŸ‚­ ğŸ‚½ ğŸƒ ğŸƒ
question	â‰ï¸ â“ â”
quiet	ğŸ”‡ ğŸ”•
rabbit	ğŸ‡ ğŸ°
bunny	ğŸ‡ ğŸ°
racing	ğŸ‡ ğŸ ğŸ
racquet	ğŸ¾
radio	ğŸ“» ğŸ”˜
radioactive	â˜¢
railway	ğŸšƒ ğŸš ğŸšŸ ğŸ›¤ğŸšˆ
rain	â˜‚ â˜”ï¸ â›† â›ˆ â›± ğŸŒ‚ ğŸŒ¦ ğŸŒ§ğŸŒˆ
rainbow	ğŸŒˆ
raised	ğŸ™‹ ğŸ™Œ
ram	ğŸ
ramen	ğŸœ
rat	ğŸ€
rays	â˜€ï¸ â˜¼ ğŸ—¤ ğŸ—¥ ğŸ—¦ ğŸ—§
receive	ğŸ“¥ ğŸ“¨ ğŸ“²
receiver	ğŸ“
record	âº â„—
recreational	ğŸš™
recycle,sign	â™² â™»ï¸
red	ğŸ€„ï¸ ğŸ‚¿ ğŸ ğŸ® ğŸ”´ ğŸ”º ğŸ”» ğŸ”¼ ğŸ”½ ğŸ˜¡
registered	Â®
relieved	ğŸ˜Œ ğŸ˜¥
reload	ğŸ”ƒ
reminder	ğŸ—
resort	â›µï¸
restaurant	ğŸ” ğŸ• ğŸ– ğŸ— ğŸ˜ ğŸ™ ğŸš ğŸ› ğŸœ ğŸ ğŸ ğŸŸ ğŸ  ğŸ¡ ğŸ¢ ğŸ£ ğŸ¤ ğŸ¥ ğŸ¦ ğŸ§ ğŸ¨ ğŸ© ğŸª ğŸ« ğŸ¬ ğŸ­ ğŸ® ğŸ¯ ğŸ° ğŸ± ğŸ² ğŸ³ ğŸ´ ğŸ½
restricted,traffic	â›  â›¡
restroom	ğŸš¹ ğŸšº ğŸš» ğŸš¾
revolver	ğŸ”«
revolving	ğŸ’ ğŸš¨
rewind	âª
ribbon	ğŸ€ ğŸ— ğŸ’
rice	ğŸŒ¾ ğŸ˜ ğŸ™ ğŸš ğŸ›
ring	ğŸ’ ğŸ•­
rise,growth	ğŸ’¹
roasted	ğŸ 
rocket	ğŸ™¬ ğŸ™­ ğŸ™® ğŸ™¯ ğŸš€
rolled	ğŸ—
roller	ğŸ¢
rolodex	ğŸ“‡
romance	ğŸ’‹ ğŸ’Œ ğŸ’ ğŸ’ ğŸ’ ğŸ’ ğŸ’‘ ğŸ’’
rook	â™– â™œ
rooster	ğŸ“
ropeway	ğŸš¡
rose	ğŸŒ¹
rosette	ğŸµ ğŸ¶
rowboat	ğŸš£
rugby	ğŸ‰
ruler	ğŸ“ ğŸ“
runner	ğŸƒ
marathon	ğŸƒ
running	ğŸ½ ğŸƒ ğŸ’¨
rushed	ğŸ˜°
rv	ğŸš™
sagittarius	â™ï¸
sailboat	â›µï¸
sake	ğŸ¶
salon	ğŸ’†
sand	âŒ›ï¸ â³
sandal,shoe	ğŸ‘¡
santa	ğŸ…
sash	ğŸ½
satchel	ğŸ’
satellite	ğŸ“¡ ğŸ›°
savouring	ğŸ˜‹
sax	ğŸ·
saxophone	ğŸ·
scales	âš–
scared	ğŸ˜¨
school	ğŸ’ ğŸ«
scissors	âœ€ âœ âœ‚ï¸ âœƒ âœ„
score	ğŸ¼ ğŸ’¯
scorpion	â™ï¸
scorpius	â™ï¸
screen	ğŸ–µ
scroll	ğŸ“œ
seafood	ğŸ¢
search	ğŸ” ğŸ”
seasons	ğŸ€¦ ğŸ€§ ğŸ€¨ ğŸ€©  
seat	ğŸ’º
secure	ğŸ”
see	ğŸ™ˆ
seedling	ğŸŒ±
sent	ğŸ“¤ ğŸ“©
set	ğŸ“
seven	ğŸ€– ğŸ€Ÿ ğŸ‚§ ğŸ‚· ğŸƒ‡ ğŸƒ— ğŸ•– ğŸ•¢
shamrock	â˜˜
sharp	â™¯
shaved	ğŸ§
shedding	ğŸŒ³
sheep	ğŸ‘ğŸ
shell	ğŸš
shield	â›¨ ğŸ›¡
shining	ğŸŒŸ
shinkansen	ğŸš„ ğŸš…
ship	ğŸš¢ ğŸ›³
shirt	ğŸ½ ğŸ‘•
shocked	ğŸ˜²
shoe	ğŸ‘ ğŸ‘Ÿ ğŸ‘ 
shogi	â˜– â˜— â›‰ â›Š
shooting	ğŸŒ 
barber,haircut	ğŸ’ˆ
shopping	ğŸ›
shortcake	ğŸ°
shot	ğŸ’‰
shower	ğŸš¿
shrimp	ğŸ¤
signal	ğŸ“¶ ğŸš¥ ğŸš¦
silent	ğŸ˜¶ ğŸ”• ğŸ”‡
silhouette	ğŸ‘¤ ğŸ‘¥ ğŸ—£
six	ğŸ€• ğŸ€ ğŸ‚¦ ğŸ‚¶ ğŸƒ† ğŸƒ– ğŸ•• ğŸ•¡ 6ï¸âƒ£
sixteenth	â™¬
size	ğŸ—š ğŸ—›
skate,ice	â›¸
ski	â›· ğŸ¿ ğŸ‚
skull	â˜  ğŸ’€ ğŸ•±
sleep	ğŸ’¤ ğŸ˜´ ğŸ›Œ ğŸ› ğŸ˜ª
sleuth	ğŸ•µ
slice	ğŸ•
slice	ğŸ°
slider	ğŸš
sliding	â›
slot	ğŸ°
smile	â˜ºï¸ â˜» ğŸ˜ ğŸ˜ƒ ğŸ˜„ ğŸ˜… ğŸ˜† ğŸ˜‡ ğŸ˜ˆ ğŸ˜Š ğŸ˜‹ ğŸ˜ ğŸ˜ ğŸ˜™ ğŸ˜¸ ğŸ˜º ğŸ˜» ğŸ˜¼ ğŸ™‚
smiley	â˜ºï¸ â˜» ğŸ˜ ğŸ˜ƒ ğŸ˜„ ğŸ˜… ğŸ˜† ğŸ˜‡ ğŸ˜ˆ ğŸ˜Š ğŸ˜‹ ğŸ˜ ğŸ˜ ğŸ˜™ ğŸ˜¸ ğŸ˜º ğŸ˜» ğŸ˜¼ ğŸ™‚
smirk	ğŸ˜
smoking	ğŸš¬ ğŸš­
snail	ğŸŒ
snake	ğŸ
sneaker	ğŸ‘Ÿ
snow	â˜ƒ â›„ï¸ â›‡ â„ï¸ ğŸŒ¨ ğŸ”
snowboard	ğŸ‚
snowflake	â„ï¸
snowman	â˜ƒ â›„ï¸ â›‡
soccer	âš½ï¸ 
soon	ğŸ”œ
sorry	ğŸ™‡
sos	ğŸ†˜
sound	ã€° â„— ğŸ“¾ ğŸ”‰ ğŸ”Š ğŸ”• ğŸ•© ğŸ•ª ğŸ•¬
southeast	â†˜ï¸
southwest	â†™ï¸
spade	â™ ï¸ â™¤ ğŸ‚¡ ğŸ‚¢ ğŸ‚£ ğŸ‚¤ ğŸ‚¥ ğŸ‚¦ ğŸ‚§ ğŸ‚¨ ğŸ‚© ğŸ‚ª ğŸ‚« ğŸ‚¬ ğŸ‚­ ğŸ‚®
spaghetti	ğŸ
sparkle	âœ¨ â‡ï¸ ğŸŒŸ ğŸ‡ ğŸ’–
speak	ğŸ™Š
speaker	ğŸ”‡ ğŸ”ˆ ğŸ”‰ ğŸ”Š ğŸ•¨ ğŸ•© ğŸ•ª
speak	ğŸ—£
speech	ğŸ’¬ ğŸ—¨ ğŸ—© ğŸ—ª ğŸ—«
speed	ğŸš„ ğŸš…
speedboat	ğŸš¤
spider	ğŸ•· ğŸ•¸
spiral	ğŸš ğŸ—’ ğŸ—“
splashing	ğŸ’¦
splayed	ğŸ– ğŸ–‘
spock	ğŸ––
sport	ğŸ…ğŸ½
ğŸ¾
ğŸ¿
ğŸ€
ğŸ‚
ğŸƒ
ğŸ„ğŸ‡
ğŸˆ
ğŸ‰
ğŸŠ
ğŸš²
ğŸš³
ğŸš´
ğŸšµğŸ½
ğŸ¾
ğŸ¿
ğŸ€
ğŸ‚
ğŸƒ
ğŸ„
ğŸ‡
ğŸˆ
ğŸ‰
ğŸŠ
ğŸ
ğŸ…
spouting	ğŸ³
spring	ğŸ€¦
springs	â™¨ï¸
spy	ğŸ•µ
square	â¹ â–ªï¸ â–«ï¸ â—»ï¸ â—¼ï¸ â—½ï¸ â—¾ï¸ â› â›¾ â â¬›ï¸ â¬œï¸  ğŸ”² ğŸ”³
triangle	ğŸ“
decorated	ğŸ“”
stadium	ğŸŸ
staff	âš• âšš
stamp,letter,mail	ğŸ–ƒ ğŸ–†
skewer	ğŸ¡ ğŸ¢
star	âœ´ï¸ â­ï¸ ğŸŒŸ ğŸŒ  ğŸ”¯
star	âœ¨ ğŸŒƒ ğŸ’«
station	â›½ï¸ ğŸš‰
statue	ğŸ—½ ğŸ—¿
steam	ğŸš‚
steaming	ğŸœ â˜• â™¨
stew	ğŸ²
stick	ğŸ¡ ğŸ¢
stock,trend,office	ğŸ— 
stop	â¹ ğŸš
stopwatch	â±
store	ğŸª ğŸ¬
straight edge	ğŸ“
strawberry	ğŸ“
berry	ğŸ“
fruit	ğŸ“
streamer	ğŸ
subway	ğŸš‡
suit	â™ ï¸ â™¡ â™¢ â™£ï¸ â™¤ â™¥ï¸ â™¦ï¸ â™§ ğŸ•´
summer	ğŸ€§
sun	â˜€ï¸ â˜¼ â›…ï¸ â›± ğŸŒ„ ğŸŒ…  ğŸŒ ğŸŒ£ ğŸŒ¤ ğŸŒ¥ ğŸŒ¦ ğŸŒ»
weather	â˜€ï¸ â˜¼ â›…ï¸ â›± ğŸŒ„ ğŸŒ… ğŸŒ ğŸŒ ğŸŒ£ ğŸŒ¤ ğŸŒ¥ ğŸŒ¦ â˜ â˜ï¸ â›…ï¸ â›† â›ˆ ğŸŒ¤ ğŸŒ¥ ğŸŒ¦ ğŸŒ§ ğŸŒ¨ ğŸŒ© ğŸŒª ğŸŒ« ğŸŒ¬â˜‚ â˜”ï¸ â›† â›ˆ â›± ğŸŒ‚ ğŸŒ¦ ğŸŒ§ğŸŒˆğŸŒ ğŸŒ«
sunflower	ğŸŒ»
eyewear,sunglasses	ğŸ•¶ ğŸ˜
sunrise,sun,time	ğŸŒ„ ğŸŒ…
sunset,sun,time	ğŸŒ† ğŸŒ‡
surfer	ğŸ„
surfing	ğŸ„
surprised	ğŸ™€
sushi	ğŸ£
suspension	ğŸšŸ
sweat	ğŸ’¦ ğŸ’§ ğŸ˜… ğŸ˜“ ğŸ˜°
sweet	ğŸ 
swim	ğŸŠ
swirl	ğŸ¥
sword	âš”
symbol	ğŸ”£
syringe	ğŸ’‰
tabs	ğŸ“‘
tangerine	ğŸŠ
tape	âœ‡ ğŸ“¼
target	ğŸ¯
tarot	ğŸƒ  ğŸƒ¡ ğŸƒ¢ ğŸƒ£ ğŸƒ¤ ğŸƒ¥ ğŸƒ¦ ğŸƒ§ ğŸƒ¨ ğŸƒ© ğŸƒª ğŸƒ« ğŸƒ¬ ğŸƒ­ ğŸƒ® ğŸƒ¯ ğŸƒ° ğŸƒ± ğŸƒ² ğŸƒ³ ğŸƒ´ ğŸƒµ
taste	ğŸ˜
taurus	â™‰ï¸
taxi	ğŸš• ğŸš–
tea,beverage	â˜•ï¸ ğŸµ
teacup	ğŸµ
tears	ğŸ˜‚ ğŸ˜­ ğŸ˜¹
telephone	â˜ï¸ â˜ âœ† ğŸ“
telescope	ğŸ”­
television	ğŸ“º
teller	ğŸ§
ten	ğŸ‚ª ğŸ‚º ğŸƒŠ ğŸƒš ğŸ”Ÿ ğŸ•™ ğŸ•¥
tennis	ğŸ¾
tent	â›ºï¸ ğŸª
text,paper	ğŸ–¹ ğŸ–º ğŸ—Ÿ
thermometer	ğŸŒ¡
thirty	ğŸ•œ ğŸ• ğŸ• ğŸ•Ÿ ğŸ•  ğŸ•¡ ğŸ•¢ ğŸ•£ ğŸ•¤ ğŸ•¥ ğŸ•¦ ğŸ•§
thought	ğŸ’­ ğŸ—¬ ğŸ—­
three	ğŸ€’ ğŸ€› ğŸ‚£ ğŸ‚³ ğŸƒƒ ğŸƒ“ ğŸ•’ ğŸ• 3ï¸âƒ£
thumb	ğŸ‘ ğŸ‘ ğŸ–’ ğŸ–“
thunder	â›ˆ
ticket	ğŸŸ ğŸ«
tiger	ğŸ… ğŸ¯
tiled,painting,art	ğŸ–½
timer	â² â³âŒ›  â³
tired	ğŸ˜© ğŸ˜«
toilet	ğŸš½
tokyo	ğŸ—¼
tomato	ğŸ…
tongue	ğŸ‘… ğŸ˜› ğŸ˜œ ğŸ˜
tool	âš’ â› ğŸ”¥ ğŸ”¦ ğŸ”§ ğŸ”¨ ğŸ”© ğŸ”ª ğŸ”« ğŸ”¬ ğŸ”­ ğŸ”® ğŸ”° ğŸ”± ğŸ› âš– âš—âœ€ âœ âœ‚ï¸ âœƒ âœ„
top	ğŸ”
torch	ğŸ”¦
tornado	ğŸŒª
totally	ğŸ˜²
tower	ğŸ—¼
railway, train	ğŸ›¤
trackball	ğŸ–²
tractor	ğŸšœ
trademark,symbol	â„¢
traffic	â›• â›– â›— ğŸš¥ ğŸš¦ â› â› â›”
train	ğŸš‚ ğŸšƒ ğŸš„ ğŸš… ğŸš† ğŸš‰ ğŸ›²
railway	ğŸš‚ ğŸšƒ ğŸš„ ğŸš… ğŸš† ğŸš‰ ğŸ›²
tram	ğŸšƒ ğŸšŠ ğŸš‹ ğŸš
trolleybus	ğŸšƒ ğŸšŠ ğŸš‹ ğŸš
tramway	ğŸš¡
travel	ğŸ‡ ğŸŠ ğŸ ğŸ ğŸš² ğŸš³ ğŸš´ ğŸšµ
tray	ğŸ“¤ ğŸ“¥
tree	ğŸŒ² ğŸŒ³ ğŸŒ´ ğŸ„ ğŸ‹
trend	ğŸ’¹ ğŸ“ˆ ğŸ“‰
trident	ğŸ”±
triumph	ğŸ˜¤
trolley	ğŸš
trophy	ğŸ†
tropical	ğŸ¹ ğŸ 
trousers	ğŸ‘–
truck	â›Ÿ ğŸš’ ğŸšš ğŸš›
trumpet	ğŸº
tulip	ğŸŒ·
turban	ğŸ‘³
turtle	ğŸ¢
tv	ğŸ“º
twelve	ğŸ•› ğŸ•§
twister	ğŸŒ€
two	ğŸ€‘ ğŸ€š ğŸ‚¢ ğŸ‚² ğŸƒ‚ ğŸƒ’ ğŸ•‘ ğŸ•
typhoon	ğŸŒ€
ufo	ğŸ‘½ ğŸ‘¾
um	ğŸ˜‹
umbrella	â˜‚ â˜”ï¸ â›± ğŸŒ‚ ğŸ–
unamused	ğŸ˜’
unexpressive	ğŸ˜‘
inexpressive	ğŸ˜‘
up	â˜ï¸ ğŸ‘† ğŸ‘ ğŸ” ğŸ–’ ğŸ– ğŸ–  ğŸ–¢ ğŸ†™
uppercase	ğŸ” 
upward,growth	ğŸ’¹ ğŸ“ˆ
urn	âš±
valentine	ğŸ’
vegetable	ğŸ… ğŸ†
once	ğŸ”‚
double	â©
âª
â«
â¬
â¿
wavy	ã€°
karaoke	ğŸ¤
instrument	ğŸ·
ğŸ¹
ğŸº
ğŸ»
halloween	ğŸƒ
vehicle	ğŸš²ğŸš³ğŸš€ ğŸš ğŸš‚ ğŸšƒ ğŸš„ ğŸš… ğŸš† ğŸš‡ ğŸšˆ ğŸš‰ ğŸšŠ ğŸš‹ ğŸšŒ ğŸš ğŸš ğŸš ğŸš‘ ğŸš’ ğŸš“ ğŸš” ğŸš• ğŸš– ğŸš— ğŸš˜ ğŸš™ ğŸšš ğŸš› ğŸšœ ğŸš ğŸš ğŸšŸ ğŸš  ğŸš¡ ğŸš¢ ğŸš£ ğŸš¤ ğŸ›¥ ğŸ›¦ ğŸ›§ ğŸ›¨ ğŸ›© ğŸ›ª ğŸ›« ğŸ›¬ ğŸ›° ğŸ›± ğŸ›² ğŸ›³
veil	ğŸ‘°
versus	ğŸ†š
vibration	ğŸ“³
victory,v	âœŒï¸ ğŸ–”
video	ğŸ“· ğŸ“¸ ğŸ“¹ ğŸ“º ğŸ“» ğŸ“¼ ğŸ“½
video game,entertainment	ğŸ® ğŸ•¹	
videocassette	ğŸ“¼
violin	ğŸ»
virgo	â™ï¸
volcano,mountain	ğŸŒ‹
voltage, electric	âš¡
electric	ï¸ğŸ”Œ
volume	ğŸ”‰ ğŸ”Š ğŸ”‡  ğŸ”ˆ  ğŸ”‰  ğŸ”Š  ğŸ•¨  ğŸ•©  ğŸ•ª
vs	ğŸ†š
vulcan	ğŸ––
walk,hike	ğŸš¶
waning	ğŸŒ– ğŸŒ˜
warning	âš ï¸
wastebasket	ğŸ—‘
watch	âŒšï¸
water	ğŸŒŠ ğŸƒ ğŸš° ğŸš± ğŸš¾ ğŸš¿
watermelon	ğŸ‰
wave	ğŸŒŠ ğŸ”‰ ğŸ•ª ğŸ•¬
waving	ğŸ³ ğŸ´ ğŸ‘‹
waxing	ğŸŒ’ ğŸŒ”
wc, lavatory, restroom	ğŸš¹ ğŸšº ğŸš» ğŸš¾ ğŸ†
weary	ğŸ˜© ğŸ™€
web	ğŸ•¸
wedding	ğŸ‘° ğŸ’’
weight	ğŸ‹
whale	ğŸ‹ ğŸ³
wheel	 ğŸ¡
wheelchair	â™¿ï¸
whew	ğŸ˜¥
wind	ğŸŒ¬ ğŸƒ ğŸ
window	ğŸ—”
wine,beverage	ğŸ·
wings	ğŸ’¸
wink	ğŸ˜‰ ğŸ˜œ
winter	ğŸ€©
wolf	ğŸº
woman	ğŸ‘’ ğŸ‘š ğŸ‘¡ ğŸ‘¢ ğŸ‘© ğŸ‘« ğŸ‘­ ğŸ‘¯ ğŸ‘µ ğŸšº ğŸ‘ 
won	ğŸ˜¤
worker	ğŸ‘·
world	ğŸ—º
worried	ğŸ˜Ÿ
wrapped	ğŸ
wrench	ğŸ”§ ğŸ› 
write	âœ ğŸ–
wry	ğŸ˜¼
yacht	â›µï¸
yang	â˜¯
yellow	ğŸ’› ğŸ”°
yen	ğŸ’´ ğŸ’¹
yin	â˜¯
young	ğŸŒ±
zodiac	â™ˆï¸ â™‰ï¸ â™Šï¸ â™‹ï¸ â™Œï¸ â™ï¸ â™ï¸ â™ï¸ â™ï¸ â™‘ï¸ â™’ï¸ â™“ï¸ â›
zzz,sleep	ğŸ’¤
slice, shortcake	ğŸ°
zero,0	0âƒ£
one,1	1âƒ£ ğŸ€ ğŸ€™ ğŸ• ğŸ•œ 1ï¸âƒ£
two,2	2âƒ£ğŸ€‘ ğŸ€š ğŸ‚¢ ğŸ‚² ğŸƒ‚ ğŸƒ’ ğŸ•‘ ğŸ• 2ï¸âƒ£
three,3	3âƒ£ğŸ€’ ğŸ€› ğŸ‚£ ğŸ‚³ ğŸƒƒ ğŸƒ“ ğŸ•’ ğŸ•  3ï¸âƒ£
four,4	4âƒ£ğŸ€“ ğŸ€œ ğŸ‚¤ ğŸ‚´ ğŸƒ„ ğŸƒ” ğŸ€ ğŸ•“ ğŸ•Ÿ 4ï¸âƒ£
five,5	5âƒ£ğŸ€” ğŸ€ ğŸ‚¥ ğŸ‚µ ğŸƒ… ğŸƒ• ğŸ•” ğŸ•  5ï¸âƒ£
six,6	6âƒ£ğŸ€• ğŸ€ ğŸ‚¦ ğŸ‚¶ ğŸƒ† ğŸƒ– ğŸ•• ğŸ•¡ 6ï¸âƒ£
seven,7	7âƒ£ğŸ€– ğŸ€Ÿ ğŸ‚§ ğŸ‚· ğŸƒ‡ ğŸƒ— ğŸ•– ğŸ•¢ 7ï¸âƒ£
eight,8	8âƒ£ğŸ€— ğŸ€  ğŸ‚¨ ğŸ‚¸ ğŸƒˆ ğŸƒ˜ ğŸ± ğŸ•— ğŸ•£ 8ï¸âƒ£
nine,9	9âƒ£ğŸ€˜ ğŸ€¡ ğŸ‚© ğŸ‚¹ ğŸƒ‰ ğŸƒ™ ğŸ•˜ ğŸ•¤ 9ï¸âƒ£
ten,10	ğŸ”ŸğŸ‚ª ğŸ‚º ğŸƒŠ ğŸƒš ğŸ”Ÿ ğŸ•™ ğŸ•¥
keycap	ğŸ”Ÿ ğŸ”Ÿ 
keycap, star, asterisk	*âƒ£
keycap, hash, pound	#âƒ£
18	ğŸ”
30	ğŸ•œ ğŸ• ğŸ• ğŸ•Ÿ ğŸ•  ğŸ•¡ ğŸ•¢ ğŸ•£ ğŸ•¤ ğŸ•¥ ğŸ•¦ ğŸ•§
11	ğŸ•š ğŸ•¦
12	ğŸ•› ğŸ•§
ram	ğŸ
zodiac	â›
triangle, alert	ğŸ›†
x, box	â›
play, right, arrow, triangle	â–¶
play, right, arrow, triangle	âµ
next track, next scene, arrow, triangle	â­
play, pause, right, arrow, triangle	â¯
reverse, left, arrow, triangle	â—€
reverse, left, arrow, triangle	â´
previous track, previous scene, arrow, triangle	â®
up, arrow, triangle	â¶
pause, double, vertical, bar	â¸
multiplication, multiply, x, cancel	âœ•
multiplication, multiply, x, cancel	âœ–
multiplication, multiply, x, cancel	ğŸ—™
multiplication, multiply, x, cancel	âŒ
plus	â•
minus	â–
ng	ğŸ†–
ideograph, congratulation	ãŠ—
ideograph, secret	ãŠ™
person	 â›· â›¹ ğŸ…  ğŸ‚ ğŸƒ ğŸ„ ğŸ‡ ğŸŠ ğŸ‹ ğŸŒ ğŸ ğŸ‘¤ ğŸ‘¥ ğŸ‘¦ ğŸ‘§ ğŸ‘¨ ğŸ‘© ğŸ‘ª ğŸ‘« ğŸ‘¬ ğŸ‘­ ğŸ‘® ğŸ‘¯ ğŸ‘° ğŸ‘± ğŸ‘² ğŸ‘³ ğŸ‘´ ğŸ‘µ ğŸ‘¶ ğŸ‘· ğŸ‘¸ ğŸ’ ğŸ’‚ ğŸ’ƒ ğŸ’† ğŸ’‡ ğŸ’ ğŸ’‘ ğŸ•² ğŸ•´ ğŸ•µ ğŸ—£ ğŸ™… ğŸ™† ğŸ™‡ ğŸ™‹ ğŸ™ ğŸ™ ğŸš´ ğŸšµ ğŸš¶ ğŸ›‰ ğŸ›Š
body	â˜š â˜› â˜œ â˜ï¸ â˜ â˜Ÿ â˜  âœŠ âœ‹ âœŒï¸ âœ ğŸ‘€ ğŸ‘ ğŸ‘‚ ğŸ‘ƒ ğŸ‘„ ğŸ‘… ğŸ‘† ğŸ‘‡ ğŸ‘ˆ ğŸ‘‰ ğŸ‘Š ğŸ‘‹ ğŸ‘Œ ğŸ‘ ğŸ‘ ğŸ‘ ğŸ‘ ğŸ‘£ ğŸ’€ ğŸ’… ğŸ’ª ğŸ•± ğŸ– ğŸ– ğŸ– ğŸ–‘ ğŸ–’ ğŸ–“ ğŸ–” ğŸ–• ğŸ–– ğŸ–— ğŸ–˜ ğŸ–™ ğŸ–š ğŸ–› ğŸ–œ ğŸ– ğŸ– ğŸ–Ÿ ğŸ–  ğŸ–¡ ğŸ–¢ ğŸ–£ ğŸ—¢ ğŸ™Œ ğŸ™
face	â˜  â˜¹ â˜ºï¸ â˜» ğŸŒš ğŸŒ› ğŸŒœ ğŸŒ ğŸŒ ğŸ­ ğŸ­ ğŸ® ğŸ¯ ğŸ° ğŸ± ğŸ² ğŸ´ ğŸµ ğŸ¶ ğŸ· ğŸ¸ ğŸ¹ ğŸº ğŸ» ğŸ¼ ğŸ‘¹ ğŸ‘º ğŸ‘» ğŸ‘¼ ğŸ‘½ ğŸ‘¾ ğŸ‘¿ ğŸ’€ ğŸ’† ğŸ•± ğŸ—£ ğŸ—¿ ğŸ˜€ ğŸ˜ ğŸ˜‚ ğŸ˜ƒ ğŸ˜„ ğŸ˜… ğŸ˜† ğŸ˜‡ ğŸ˜ˆ ğŸ˜‰ ğŸ˜Š ğŸ˜‹ ğŸ˜Œ ğŸ˜ ğŸ˜ ğŸ˜ ğŸ˜ ğŸ˜‘ ğŸ˜’ ğŸ˜“ ğŸ˜” ğŸ˜• ğŸ˜– ğŸ˜— ğŸ˜˜ ğŸ˜™ ğŸ˜š ğŸ˜› ğŸ˜œ ğŸ˜ ğŸ˜ ğŸ˜Ÿ ğŸ˜  ğŸ˜¡ ğŸ˜¢ ğŸ˜£ ğŸ˜¤ ğŸ˜¥ ğŸ˜¦ ğŸ˜§ ğŸ˜¨ ğŸ˜© ğŸ˜ª ğŸ˜« ğŸ˜¬ ğŸ˜­ ğŸ˜® ğŸ˜¯ ğŸ˜° ğŸ˜± ğŸ˜² ğŸ˜³ ğŸ˜´ ğŸ˜µ ğŸ˜¶ ğŸ˜· ğŸ˜¸ ğŸ˜¹ ğŸ˜º ğŸ˜» ğŸ˜¼ ğŸ˜½ ğŸ˜¾ ğŸ˜¿ ğŸ™€ ğŸ™ ğŸ™‚ ğŸ™ˆ ğŸ™‰ ğŸ™Š
nature	â¸™ â˜˜ âš¡ï¸ â­ï¸ ğŸŒ ğŸŒ ğŸŒ ğŸŒ ğŸŒ  ğŸŒ° ğŸŒ± ğŸŒ² ğŸŒ³ ğŸŒ´ ğŸŒµ ğŸŒ¶ ğŸŒ· ğŸŒ¸ ğŸŒ¹ ğŸŒº ğŸŒ» ğŸŒ¼ ğŸŒ½ ğŸŒ¾ ğŸŒ¿ ğŸ€ ğŸ ğŸ‚ ğŸƒ ğŸ„ ğŸ… ğŸ† ğŸ‡ ğŸˆ ğŸ‰ ğŸŠ ğŸ‹ ğŸŒ ğŸ ğŸ ğŸ ğŸ ğŸ‘ ğŸ’ ğŸ“ ğŸ• ğŸ” ğŸ• ğŸ– ğŸœ ğŸ ğŸ ğŸµ ğŸ¶ ğŸ€ ğŸ ğŸ‚ ğŸƒ ğŸ„ ğŸ… ğŸ† ğŸ‡ ğŸˆ ğŸ‰ ğŸŠ ğŸ‹ ğŸŒ ğŸ ğŸ ğŸ ğŸ ğŸ‘ ğŸ’ ğŸ“ ğŸ” ğŸ• ğŸ– ğŸ— ğŸ˜ ğŸ™ ğŸš ğŸ› ğŸœ ğŸ ğŸ ğŸŸ ğŸ  ğŸ¡ ğŸ¢ ğŸ£ ğŸ¤ ğŸ¥ ğŸ¦ ğŸ§ ğŸ¨ ğŸ© ğŸª ğŸ« ğŸ¬ ğŸ­ ğŸ® ğŸ¯ ğŸ° ğŸ± ğŸ² ğŸ³ ğŸ´ ğŸµ ğŸ¶ ğŸ· ğŸ¸ ğŸ¹ ğŸº ğŸ» ğŸ¼ ğŸ½ ğŸ¾ ğŸ¿ ğŸ‘½ ğŸ‘¾ ğŸ’ ğŸ’© ğŸ•Š ğŸ—² ğŸ˜¸ ğŸ˜¹ ğŸ˜º ğŸ˜» ğŸ˜¼ ğŸ˜½ ğŸ˜¾ ğŸ˜¿ ğŸ™€ ğŸ—» ğŸŒ‹ ğŸŒ ğŸŒ« 
clothing	ğŸ‘‘ ğŸ‘’ ğŸ‘“ ğŸ‘” ğŸ‘• ğŸ‘– ğŸ‘— ğŸ‘˜ ğŸ‘™ ğŸ‘š ğŸ‘› ğŸ‘œ ğŸ‘ ğŸ‘ ğŸ‘Ÿ ğŸ‘  ğŸ‘¡ ğŸ‘¢
emotion	â˜™ â™¥ï¸ â£ â¤ï¸ â¥ â¦ â§ ğŸ” ğŸ• ğŸ’‹ ğŸ’Œ ğŸ’“ ğŸ’” ğŸ’• ğŸ’– ğŸ’— ğŸ’˜ ğŸ’™ ğŸ’š ğŸ’› ğŸ’œ ğŸ’ ğŸ’ ğŸ’Ÿ ğŸ’¢ ğŸ’£ ğŸ’¤ ğŸ’¥ ğŸ’¦ ğŸ’§ ğŸ’¨ ğŸ’« ğŸ’¬ ğŸ’­ ğŸ—¤ ğŸ—¥ ğŸ—¦ ğŸ—§ ğŸ—¨ ğŸ—© ğŸ—ª ğŸ—« ğŸ—¬ ğŸ—­ ğŸ—® ğŸ—¯ ğŸ—° ğŸ—± ğŸ—²
food	â˜•ï¸ â›¾ ğŸŒ¶ ğŸ” ğŸ• ğŸ– ğŸ— ğŸ˜ ğŸ™ ğŸš ğŸ› ğŸœ ğŸ ğŸ ğŸŸ ğŸ  ğŸ¡ ğŸ¢ ğŸ£ ğŸ¤ ğŸ¥ ğŸ¦ ğŸ§ ğŸ¨ ğŸ© ğŸª ğŸ« ğŸ¬ ğŸ­ ğŸ® ğŸ¯ ğŸ° ğŸ± ğŸ² ğŸ³ ğŸ´ ğŸµ ğŸ¶ ğŸ· ğŸ¸ ğŸ¹ ğŸº ğŸ» ğŸ¼ ğŸ½ ğŸ‚ ğŸ˜‹
travel	âˆ â™¨ï¸ â™»ï¸ â™¿ï¸ âš“ï¸ âš ï¸ âš¡ï¸ â› â› â› â›‘ â›’ â›“ â›”ï¸ â›• â›– â›— â›˜ â›™ â›› â›œ â› â› â›Ÿ â›  â›¡ â›¨ â›± â›³ï¸ â›´ â›µï¸ â›· â›¸ â›¹ â›½ï¸ â›¾ â›¿ âœˆï¸ â­•ï¸ ğŸ‡ ğŸŠ ğŸ ğŸ ğŸ’º ğŸ—¿ ğŸ™¬ ğŸ™­ ğŸ™® ğŸ™¯ ğŸš€ ğŸš ğŸš‚ ğŸšƒ ğŸš„ ğŸš… ğŸš† ğŸš‡ ğŸšˆ ğŸš‰ ğŸšŠ ğŸš‹ ğŸšŒ ğŸš ğŸš ğŸš ğŸš ğŸš‘ ğŸš’ ğŸš“ ğŸš” ğŸš• ğŸš– ğŸš— ğŸš˜ ğŸš™ ğŸšš ğŸš› ğŸšœ ğŸš ğŸš ğŸšŸ ğŸš  ğŸš¡ ğŸš¢ ğŸš£ ğŸš¤ ğŸš¥ ğŸš¦ ğŸš§ ğŸš¨ ğŸš© ğŸšª ğŸš« ğŸš¬ ğŸš­ ğŸš® ğŸš¯ ğŸš° ğŸš± ğŸš² ğŸš³ ğŸš´ ğŸšµ ğŸš¶ ğŸš· ğŸš¸ ğŸš¹ ğŸšº ğŸš» ğŸš¼ ğŸš½ ğŸš¾ ğŸš¿ ğŸ›€ ğŸ› ğŸ›‚ ğŸ›ƒ ğŸ›„ ğŸ›… ğŸ›† ğŸ›‡ ğŸ›£ ğŸ›¤ ğŸ›¥ ğŸ›¦ ğŸ›§ ğŸ›¨ ğŸ›© ğŸ›ª ğŸ›« ğŸ›¬ ğŸ›± ğŸ›² ğŸ›³ ğŸ†
place	â˜½ â˜¾ â›ªï¸ â›° â›²ï¸ â›ºï¸ ğŸŒ ğŸŒƒ ğŸŒ„ ğŸŒ… ğŸŒ† ğŸŒ‡ ğŸŒ‰ ğŸŒŠ ğŸŒ‹ ğŸŒŒ ğŸŒ ğŸŒ ğŸŒ ğŸŒ ğŸŒ‘ ğŸŒ’ ğŸŒ“ ğŸŒ” ğŸŒ• ğŸŒ– ğŸŒ— ğŸŒ˜ ğŸŒ™ ğŸŒš ğŸŒ› ğŸŒœ ğŸŒ ğŸŒ ğŸŒŸ ğŸŒ  ğŸ  ğŸ¡ ğŸ¢ ğŸª ğŸ« ğŸ­ ğŸ° ğŸ” ğŸ• ğŸ– ğŸ— ğŸ˜ ğŸ™ ğŸš ğŸ› ğŸœ ğŸ ğŸ ğŸŸ ğŸ  ğŸ¡ ğŸ¢ ğŸ£ ğŸ¤ ğŸ¥ ğŸ¦ ğŸ§ ğŸ¨ ğŸ© ğŸª ğŸ« ğŸ¬ ğŸ­ ğŸ® ğŸ¯ ğŸ° ğŸ’ˆ ğŸ’’ ğŸ“ ğŸ”° ğŸ—º ğŸ—» ğŸ—¼ ğŸ—½ ğŸ—¾ ğŸš® ğŸ›ˆ ğŸ›°
office	 ğŸ“„â˜ï¸ â˜ âœ€ âœ âœ‚ï¸ âœƒ âœ„ âœ† âœ‡ âœ‰ï¸ âœ âœï¸ âœ âœ‘ âœ’ï¸ ğŸ¢ ğŸ£ ğŸ¤ ğŸ’¯ ğŸ’° ğŸ’± ğŸ’² ğŸ’³ ğŸ’´ ğŸ’µ ğŸ’¶ ğŸ’· ğŸ’¸ ğŸ’¹ ğŸ’º ğŸ’» ğŸ’¼ ğŸ’½ ğŸ’¾ ğŸ’¿ ğŸ“€ ğŸ“ ğŸ“‚ ğŸ“ƒ ğŸ“„ ğŸ“… ğŸ“† ğŸ“‡ ğŸ“ˆ ğŸ“‰ ğŸ“Š ğŸ“‹ ğŸ“Œ ğŸ“ ğŸ“ ğŸ“ ğŸ“ ğŸ“‘ ğŸ“’ ğŸ““ ğŸ“” ğŸ“• ğŸ“– ğŸ“— ğŸ“˜ ğŸ“™ ğŸ“š ğŸ“› ğŸ“œ ğŸ“ ğŸ“Ÿ ğŸ“  ğŸ“¡ ğŸ“¤ ğŸ“¥ ğŸ“¦ ğŸ“§ ğŸ“¨ ğŸ“© ğŸ“ª ğŸ“« ğŸ“¬ ğŸ“­ ğŸ“® ğŸ–‚ ğŸ–ƒ ğŸ–„ ğŸ–… ğŸ–† ğŸ–‡ ğŸ–ˆ ğŸ–‰ ğŸ–Š ğŸ–‹ ğŸ–Œ ğŸ– ğŸ–¥ ğŸ–¦ ğŸ–§ ğŸ–¨ ğŸ–© ğŸ–® ğŸ–¯ ğŸ–° ğŸ–± ğŸ–² ğŸ–³ ğŸ–´ ğŸ–µ ğŸ–¶ ğŸ–· ğŸ–¸ ğŸ–¹ ğŸ–º ğŸ–¿ ğŸ—€ ğŸ— ğŸ—‚ ğŸ—ƒ ğŸ—„ ğŸ—… ğŸ—† ğŸ—‡ ğŸ—ˆ ğŸ—‰ ğŸ—Š ğŸ—‹ ğŸ—Œ ğŸ— ğŸ— ğŸ— ğŸ— ğŸ—‘ ğŸ—’ ğŸ—“ ğŸ—” ğŸ—• ğŸ—– ğŸ——
time	âŒšï¸ âŒ›ï¸ â° â± â² â³ â™ˆï¸ â™‰ï¸ â™Šï¸ â™‹ï¸ â™Œï¸ â™ï¸ â™ï¸ â™ï¸ â™ï¸ â™‘ï¸ â™’ï¸ â™“ï¸ ğŸŒ‘ ğŸŒ’ ğŸŒ“ ğŸŒ” ğŸŒ• ğŸŒ– ğŸŒ— ğŸŒ˜ ğŸŒ™ ğŸŒš ğŸ• ğŸ•‘ ğŸ•’ ğŸ•“ ğŸ•” ğŸ•• ğŸ•– ğŸ•— ğŸ•˜ ğŸ•™ ğŸ•š ğŸ•› ğŸ•œ ğŸ• ğŸ• ğŸ•Ÿ ğŸ•  ğŸ•¡ ğŸ•¢ ğŸ•£ ğŸ•¤ ğŸ•¥ ğŸ•¦ ğŸ•§
weather	â˜€ï¸ â˜ï¸ â˜‚ â˜ƒ â˜”ï¸ â˜¼ â›„ï¸ â›…ï¸ â›† â›‡ â›ˆ â›± â„ï¸ ğŸŒ€ ğŸŒ ğŸŒ‚ ğŸŒƒ ğŸŒ„ ğŸŒ… ğŸŒ† ğŸŒ‡ ğŸŒˆ ğŸŒ‰ ğŸŒŠ ğŸŒ‹ ğŸŒŒ ğŸŒ‘ ğŸŒ’ ğŸŒ“ ğŸŒ” ğŸŒ• ğŸŒ– ğŸŒ— ğŸŒ˜ ğŸŒ™ ğŸŒš ğŸŒ› ğŸŒœ ğŸŒ ğŸŒ ğŸŒ¡ ğŸŒ¢ ğŸŒ£ ğŸŒ¤ ğŸŒ¥ ğŸŒ¦ ğŸŒ§ ğŸŒ¨ ğŸŒ© ğŸŒª ğŸŒ« ğŸŒ¬ ğŸ’§
game	â˜– â˜— â™” â™• â™– â™— â™˜ â™™ â™š â™› â™œ â™ â™ â™Ÿ â™ ï¸ â™¡ â™¢ â™£ï¸ â™¤ â™¥ï¸ â™¦ï¸ â™§ âš€ âš âš‚ âšƒ âš„ âš… â›€ â› â›‚ â›ƒ â›‰ â›Š ğŸ€€ ğŸ€ ğŸ€‚ ğŸ€ƒ ğŸ€„ï¸ ğŸ€… ğŸ€† ğŸ€‡ ğŸ€ˆ ğŸ€‰ ğŸ€Š ğŸ€‹ ğŸ€Œ ğŸ€ ğŸ€ ğŸ€ ğŸ€ ğŸ€‘ ğŸ€’ ğŸ€“ ğŸ€” ğŸ€• ğŸ€– ğŸ€— ğŸ€˜ ğŸ€™ ğŸ€š ğŸ€› ğŸ€œ ğŸ€ ğŸ€ ğŸ€Ÿ ğŸ€  ğŸ€¡ ğŸ€¢ ğŸ€£ ğŸ€¤ ğŸ€¥ ğŸ€¦ ğŸ€§ ğŸ€¨ ğŸ€© ğŸ€ª ğŸ€« ğŸ€° ğŸ€± ğŸ€² ğŸ€³ ğŸ€´ ğŸ€µ ğŸ€¶ ğŸ€· ğŸ€¸ ğŸ€¹ ğŸ€º ğŸ€» ğŸ€¼ ğŸ€½ ğŸ€¾ ğŸ€¿ ğŸ€ ğŸ ğŸ‚ ğŸƒ ğŸ„ ğŸ… ğŸ† ğŸ‡ ğŸˆ ğŸ‰ ğŸŠ ğŸ‹ ğŸŒ ğŸ ğŸ ğŸ ğŸ ğŸ‘ ğŸ’ ğŸ“ ğŸ” ğŸ• ğŸ– ğŸ— ğŸ˜ ğŸ™ ğŸš ğŸ› ğŸœ ğŸ ğŸ ğŸŸ ğŸ  ğŸ¡ ğŸ¢ ğŸ£ ğŸ¤ ğŸ¥ ğŸ¦ ğŸ§ ğŸ¨ ğŸ© ğŸª ğŸ« ğŸ¬ ğŸ­ ğŸ® ğŸ¯ ğŸ° ğŸ± ğŸ² ğŸ³ ğŸ´ ğŸµ ğŸ¶ ğŸ· ğŸ¸ ğŸ¹ ğŸº ğŸ» ğŸ¼ ğŸ½ ğŸ¾ ğŸ¿ ğŸ‚€ ğŸ‚ ğŸ‚‚ ğŸ‚ƒ ğŸ‚„ ğŸ‚… ğŸ‚† ğŸ‚‡ ğŸ‚ˆ ğŸ‚‰ ğŸ‚Š ğŸ‚‹ ğŸ‚Œ ğŸ‚ ğŸ‚ ğŸ‚ ğŸ‚ ğŸ‚‘ ğŸ‚’ ğŸ‚“ ğŸ‚  ğŸ‚¡ ğŸ‚¢ ğŸ‚£ ğŸ‚¤ ğŸ‚¥ ğŸ‚¦ ğŸ‚§ ğŸ‚¨ ğŸ‚© ğŸ‚ª ğŸ‚« ğŸ‚¬ ğŸ‚­ ğŸ‚® ğŸ‚± ğŸ‚² ğŸ‚³ ğŸ‚´ ğŸ‚µ ğŸ‚¶ ğŸ‚· ğŸ‚¸ ğŸ‚¹ ğŸ‚º ğŸ‚» ğŸ‚¼ ğŸ‚½ ğŸ‚¾ ğŸ‚¿ ğŸƒ ğŸƒ‚ ğŸƒƒ ğŸƒ„ ğŸƒ… ğŸƒ† ğŸƒ‡ ğŸƒˆ ğŸƒ‰ ğŸƒŠ ğŸƒ‹ ğŸƒŒ ğŸƒ ğŸƒ ğŸƒ ğŸƒ‘ ğŸƒ’ ğŸƒ“ ğŸƒ” ğŸƒ• ğŸƒ– ğŸƒ— ğŸƒ˜ ğŸƒ™ ğŸƒš ğŸƒ› ğŸƒœ ğŸƒ ğŸƒ ğŸƒŸ ğŸƒ  ğŸƒ¡ ğŸƒ¢ ğŸƒ£ ğŸƒ¤ ğŸƒ¥ ğŸƒ¦ ğŸƒ§ ğŸƒ¨ ğŸƒ© ğŸƒª ğŸƒ« ğŸƒ¬ ğŸƒ­ ğŸƒ® ğŸƒ¯ ğŸƒ° ğŸƒ± ğŸƒ² ğŸƒ³ ğŸƒ´ ğŸƒµ ğŸ® ğŸ²
sport	âš½ï¸ âš¾ï¸ â›³ï¸ â›· â›¸ â›¹ ğŸ£ ğŸ± ğŸ³ ğŸ½ ğŸ¾ ğŸ¿ ğŸ€ ğŸ ğŸ‚ ğŸƒ ğŸ„ ğŸ… ğŸ† ğŸ‡ ğŸˆ ğŸ‰ ğŸŠ ğŸ‹ ğŸŒ ğŸ ğŸ ğŸš² ğŸš³ ğŸš´ ğŸšµ
activity	ğŸŒ  ğŸƒ ğŸ„ ğŸ… ğŸ† ğŸ‡ ğŸˆ ğŸ‰ ğŸŠ ğŸ‹ ğŸŒ ğŸ ğŸ ğŸ ğŸ ğŸ‘ ğŸ’ ğŸ“ ğŸ  ğŸ¡ ğŸ¢ ğŸ¤ ğŸ¥ ğŸ¦ ğŸ§ ğŸ¨ ğŸ© ğŸª ğŸ« ğŸ¬ ğŸ­ ğŸ¯ ğŸ° ğŸ´ ğŸµ ğŸ¶ ğŸ· ğŸ¸ ğŸ¹ ğŸº ğŸ» ğŸ¼ ğŸ’’ ğŸš¬
object	â˜„ â˜¤ â˜¸ âš’ âš” âš• âš– âš— âš˜ âš™ âšš âš› âšœ âš° âš± âš¿ â› â›“ â›¨ â›²ï¸ â›¼ âœ€ ğŸ€ ğŸ ğŸƒ ğŸ„ ğŸ† ğŸ‡ ğŸˆ ğŸ‰ ğŸŠ ğŸ‹ ğŸ ğŸ ğŸ ğŸ‘ ğŸ’ ğŸ“ ğŸ– ğŸ— ğŸ˜ ğŸ™ ğŸš ğŸ› ğŸ ğŸŸ ğŸ¥ ğŸ¦ ğŸ¨ ğŸ© ğŸ« ğŸ¬ ğŸ­ ğŸ¯ ğŸ° ğŸ´ ğŸ· ğŸ’„ ğŸ’‰ ğŸ’Š ğŸ’ ğŸ’ ğŸ’ ğŸ’¡ ğŸ’£ ğŸ’¦ ğŸ’§ ğŸ’¨ ğŸ’© ğŸ’® ğŸ“¯ ğŸ“° ğŸ“± ğŸ“² ğŸ“³ ğŸ“´ ğŸ“µ ğŸ“¶ ğŸ“· ğŸ“¸ ğŸ“¹ ğŸ“º ğŸ“» ğŸ“¼ ğŸ“½ ğŸ”‹ ğŸ”Œ ğŸ” ğŸ” ğŸ” ğŸ” ğŸ”‘ ğŸ”’ ğŸ”“ ğŸ”– ğŸ”— ğŸ”¥ ğŸ”¦ ğŸ”§ ğŸ”¨ ğŸ”© ğŸ”ª ğŸ”« ğŸ”¬ ğŸ”­ ğŸ”® ğŸ”¯ ğŸ”° ğŸ”± ğŸ•® ğŸ•¯ ğŸ•° ğŸ•¶ ğŸ•· ğŸ•¸ ğŸ•¹ ğŸ–» ğŸ–¼ ğŸ–½ ğŸ–¾ ğŸ—œ ğŸ— ğŸ— ğŸ—Ÿ ğŸ—  ğŸ—¡ ğŸ—³ ğŸšª ğŸš¬ ğŸš½ ğŸš¿ ğŸ›€ ğŸ› ğŸ›‹ ğŸ›Œ ğŸ› ğŸ› ğŸ› ğŸ›  ğŸ›¡ ğŸ›¢
sound	ğŸ”‡ ğŸ”ˆ ğŸ”‰ ğŸ”Š ğŸ•¨ ğŸ•© ğŸ•ª ğŸ•« ğŸ•¬ â â© âª â« â¬ â­ â® â¯ â´ âµ â¶ â· â¸ â¹ âº â–¶ï¸ â—€ï¸ â˜ï¸ â˜ â™© â™ª â™« â™¬ â™­ â™® â™¯ ğŸ˜ ğŸ™ ğŸš ğŸ› ğŸœ ğŸ ğŸ¤ ğŸ§ ğŸµ ğŸ¶ ğŸ· ğŸ¸ ğŸ¹ ğŸº ğŸ» ğŸ¼ ğŸ“ ğŸ“¢ ğŸ“£ ğŸ“¯ ğŸ“¾ ğŸ”‡ ğŸ”ˆ ğŸ”‰ ğŸ”Š ğŸ”” ğŸ”• ğŸ•¨ ğŸ•© ğŸ•ª ğŸ•« ğŸ•¬ ğŸ•­ ğŸ–
flag	âš âš‘ â›³ï¸ â›¿ ğŸŒ ğŸ ğŸ± ğŸ² ğŸ³ ğŸ´ ğŸš© ğŸ‡¦ğŸ‡© ğŸ‡¦ğŸ‡ª ğŸ‡¦ğŸ‡« ğŸ‡¦ğŸ‡¬ ğŸ‡¦ğŸ‡® ğŸ‡¦ğŸ‡± ğŸ‡¦ğŸ‡² ğŸ‡¦ğŸ‡´ ğŸ‡¦ğŸ‡¶ ğŸ‡¦ğŸ‡· ğŸ‡¦ğŸ‡¸ ğŸ‡¦ğŸ‡¹ ğŸ‡¦ğŸ‡º ğŸ‡¦ğŸ‡¼ ğŸ‡¦ğŸ‡½ ğŸ‡¦ğŸ‡¿ ğŸ‡§ğŸ‡¦ ğŸ‡§ğŸ‡§ ğŸ‡§ğŸ‡© ğŸ‡§ğŸ‡ª ğŸ‡§ğŸ‡« ğŸ‡§ğŸ‡¬ ğŸ‡§ğŸ‡­ ğŸ‡§ğŸ‡® ğŸ‡§ğŸ‡¯ ğŸ‡§ğŸ‡± ğŸ‡§ğŸ‡² ğŸ‡§ğŸ‡³ ğŸ‡§ğŸ‡´ ğŸ‡§ğŸ‡¶ ğŸ‡§ğŸ‡· ğŸ‡§ğŸ‡¸ ğŸ‡§ğŸ‡¹ ğŸ‡§ğŸ‡» ğŸ‡§ğŸ‡¼ ğŸ‡§ğŸ‡¾ ğŸ‡§ğŸ‡¿ ğŸ‡¨ğŸ‡¦ ğŸ‡¨ğŸ‡¨ ğŸ‡¨ğŸ‡© ğŸ‡¨ğŸ‡« ğŸ‡¨ğŸ‡¬ ğŸ‡¨ğŸ‡­ ğŸ‡¨ğŸ‡® ğŸ‡¨ğŸ‡° ğŸ‡¨ğŸ‡± ğŸ‡¨ğŸ‡² ğŸ‡¨ğŸ‡³ ğŸ‡¨ğŸ‡´ ğŸ‡¨ğŸ‡· ğŸ‡¨ğŸ‡º ğŸ‡¨ğŸ‡» ğŸ‡¨ğŸ‡¼ ğŸ‡¨ğŸ‡½ ğŸ‡¨ğŸ‡¾ ğŸ‡¨ğŸ‡¿ ğŸ‡©ğŸ‡ª ğŸ‡©ğŸ‡¯ ğŸ‡©ğŸ‡° ğŸ‡©ğŸ‡² ğŸ‡©ğŸ‡´ ğŸ‡©ğŸ‡¿ ğŸ‡ªğŸ‡¨ ğŸ‡ªğŸ‡ª ğŸ‡ªğŸ‡¬ ğŸ‡ªğŸ‡­ ğŸ‡ªğŸ‡· ğŸ‡ªğŸ‡¸ ğŸ‡ªğŸ‡¹ ğŸ‡«ğŸ‡® ğŸ‡«ğŸ‡¯ ğŸ‡«ğŸ‡° ğŸ‡«ğŸ‡² ğŸ‡«ğŸ‡´ ğŸ‡«ğŸ‡· ğŸ‡¬ğŸ‡¦ ğŸ‡¬ğŸ‡§ ğŸ‡¬ğŸ‡© ğŸ‡¬ğŸ‡ª ğŸ‡¬ğŸ‡« ğŸ‡¬ğŸ‡¬ ğŸ‡¬ğŸ‡­ ğŸ‡¬ğŸ‡® ğŸ‡¬ğŸ‡± ğŸ‡¬ğŸ‡² ğŸ‡¬ğŸ‡³ ğŸ‡¬ğŸ‡µ ğŸ‡¬ğŸ‡¶ ğŸ‡¬ğŸ‡· ğŸ‡¬ğŸ‡¸ ğŸ‡¬ğŸ‡¹ ğŸ‡¬ğŸ‡º ğŸ‡¬ğŸ‡¼ ğŸ‡¬ğŸ‡¾ ğŸ‡­ğŸ‡° ğŸ‡­ğŸ‡² ğŸ‡­ğŸ‡³ ğŸ‡­ğŸ‡· ğŸ‡­ğŸ‡¹ ğŸ‡­ğŸ‡º ğŸ‡®ğŸ‡© ğŸ‡®ğŸ‡ª ğŸ‡®ğŸ‡± ğŸ‡®ğŸ‡² ğŸ‡®ğŸ‡³ ğŸ‡®ğŸ‡´ ğŸ‡®ğŸ‡¶ ğŸ‡®ğŸ‡· ğŸ‡®ğŸ‡¸ ğŸ‡®ğŸ‡¹ ğŸ‡¯ğŸ‡ª ğŸ‡¯ğŸ‡² ğŸ‡¯ğŸ‡´ ğŸ‡¯ğŸ‡µ ğŸ‡°ğŸ‡ª ğŸ‡°ğŸ‡¬ ğŸ‡°ğŸ‡­ ğŸ‡°ğŸ‡® ğŸ‡°ğŸ‡² ğŸ‡°ğŸ‡³ ğŸ‡°ğŸ‡µ ğŸ‡°ğŸ‡· ğŸ‡°ğŸ‡¼ ğŸ‡°ğŸ‡¾ ğŸ‡°ğŸ‡¿ ğŸ‡±ğŸ‡¦ ğŸ‡±ğŸ‡§ ğŸ‡±ğŸ‡¨ ğŸ‡±ğŸ‡® ğŸ‡±ğŸ‡° ğŸ‡±ğŸ‡· ğŸ‡±ğŸ‡¸ ğŸ‡±ğŸ‡¹ ğŸ‡±ğŸ‡º ğŸ‡±ğŸ‡» ğŸ‡±ğŸ‡¾ ğŸ‡²ğŸ‡¦ ğŸ‡²ğŸ‡¨ ğŸ‡²ğŸ‡© ğŸ‡²ğŸ‡ª ğŸ‡²ğŸ‡« ğŸ‡²ğŸ‡¬ ğŸ‡²ğŸ‡­ ğŸ‡²ğŸ‡° ğŸ‡²ğŸ‡± ğŸ‡²ğŸ‡² ğŸ‡²ğŸ‡³ ğŸ‡²ğŸ‡´ ğŸ‡²ğŸ‡µ ğŸ‡²ğŸ‡¶ ğŸ‡²ğŸ‡· ğŸ‡²ğŸ‡¸ ğŸ‡²ğŸ‡¹ ğŸ‡²ğŸ‡º ğŸ‡²ğŸ‡» ğŸ‡²ğŸ‡¼ ğŸ‡²ğŸ‡½ ğŸ‡²ğŸ‡¾ ğŸ‡²ğŸ‡¿ ğŸ‡³ğŸ‡¦ ğŸ‡³ğŸ‡¨ ğŸ‡³ğŸ‡ª ğŸ‡³ğŸ‡« ğŸ‡³ğŸ‡¬ ğŸ‡³ğŸ‡® ğŸ‡³ğŸ‡± ğŸ‡³ğŸ‡´ ğŸ‡³ğŸ‡µ ğŸ‡³ğŸ‡· ğŸ‡³ğŸ‡º ğŸ‡³ğŸ‡¿ ğŸ‡´ğŸ‡² ğŸ‡µğŸ‡¦ ğŸ‡µğŸ‡ª ğŸ‡µğŸ‡« ğŸ‡µğŸ‡¬ ğŸ‡µğŸ‡­ ğŸ‡µğŸ‡° ğŸ‡µğŸ‡± ğŸ‡µğŸ‡² ğŸ‡µğŸ‡³ ğŸ‡µğŸ‡· ğŸ‡µğŸ‡¸ ğŸ‡µğŸ‡¹ ğŸ‡µğŸ‡¼ ğŸ‡µğŸ‡¾ ğŸ‡¶ğŸ‡¦ ğŸ‡·ğŸ‡ª ğŸ‡·ğŸ‡´ ğŸ‡·ğŸ‡¸ ğŸ‡·ğŸ‡º ğŸ‡·ğŸ‡¼ ğŸ‡¸ğŸ‡¦ ğŸ‡¸ğŸ‡§ ğŸ‡¸ğŸ‡¨ ğŸ‡¸ğŸ‡© ğŸ‡¸ğŸ‡ª ğŸ‡¸ğŸ‡¬ ğŸ‡¸ğŸ‡­ ğŸ‡¸ğŸ‡® ğŸ‡¸ğŸ‡¯ ğŸ‡¸ğŸ‡° ğŸ‡¸ğŸ‡± ğŸ‡¸ğŸ‡² ğŸ‡¸ğŸ‡³ ğŸ‡¸ğŸ‡´ ğŸ‡¸ğŸ‡· ğŸ‡¸ğŸ‡¸ ğŸ‡¸ğŸ‡¹ ğŸ‡¸ğŸ‡» ğŸ‡¸ğŸ‡½ ğŸ‡¸ğŸ‡¾ ğŸ‡¸ğŸ‡¿ ğŸ‡¹ğŸ‡¨ ğŸ‡¹ğŸ‡© ğŸ‡¹ğŸ‡« ğŸ‡¹ğŸ‡¬ ğŸ‡¹ğŸ‡­ ğŸ‡¹ğŸ‡¯ ğŸ‡¹ğŸ‡° ğŸ‡¹ğŸ‡± ğŸ‡¹ğŸ‡² ğŸ‡¹ğŸ‡³ ğŸ‡¹ğŸ‡´ ğŸ‡¹ğŸ‡· ğŸ‡¹ğŸ‡¹ ğŸ‡¹ğŸ‡» ğŸ‡¹ğŸ‡¼ ğŸ‡¹ğŸ‡¿ ğŸ‡ºğŸ‡¦ ğŸ‡ºğŸ‡¬ ğŸ‡ºğŸ‡² ğŸ‡ºğŸ‡¸ ğŸ‡ºğŸ‡¾ ğŸ‡ºğŸ‡¿ ğŸ‡»ğŸ‡¦ ğŸ‡»ğŸ‡¨ ğŸ‡»ğŸ‡ª ğŸ‡»ğŸ‡¬ ğŸ‡»ğŸ‡® ğŸ‡»ğŸ‡³ ğŸ‡»ğŸ‡º ğŸ‡¼ğŸ‡« ğŸ‡¼ğŸ‡¸ ğŸ‡¾ğŸ‡ª ğŸ‡¾ğŸ‡¹ ğŸ‡¿ğŸ‡¦ ğŸ‡¿ğŸ‡² ğŸ‡¿ğŸ‡¼
arrow	â†”ï¸ â†•ï¸ â†–ï¸ â†—ï¸ â†˜ï¸ â†™ï¸ â†©ï¸ â†ªï¸ â© âª â« â¬ â¡ï¸ â¤´ï¸ â¤µï¸ â¬…ï¸ â¬†ï¸ â¬‡ï¸ ğŸ’˜ ğŸ“² ğŸ”€ ğŸ” ğŸ”‚ ğŸ”ƒ ğŸ”„ ğŸ”™ ğŸ”š ğŸ”› ğŸ”œ ğŸ” ğŸ”¼ ğŸ”½ ğŸ—˜
word	â€¼ï¸ â‰ï¸ Â© Â® â› â“ â” â• â—ï¸ â¢ ğŸ’¤ ğŸ” ğŸ”Ÿ ğŸ”  ğŸ”¡ ğŸ”¢ ğŸ”£ ğŸ”¤ ğŸ—š ğŸ—› ğŸ…° ğŸ† ğŸ…± ğŸ†‘ ğŸ†’ ğŸ†“ â„¹ï¸ ğŸ†” â“‚ï¸ ğŸ†• ğŸ†– ğŸ…¾ ğŸ†— ğŸ…¿ï¸ ğŸ†˜ â„¢ ğŸ†™ ğŸ†š ğŸˆ ğŸˆ‚ ğŸˆ¹ ğŸ‰‘ ğŸˆ´ ğŸˆº ğŸ‰ ğŸˆ¯ï¸ ğŸˆ· ğŸˆ¶ ğŸˆµ ğŸˆšï¸ ğŸˆ¸ ãŠ—ï¸ ğŸˆ² ãŠ™ï¸ ğŸˆ³ #ï¸âƒ£ 0ï¸âƒ£ 1ï¸âƒ£ 2ï¸âƒ£ 3ï¸âƒ£ 4ï¸âƒ£ 5ï¸âƒ£ 6ï¸âƒ£ 7ï¸âƒ£ 8ï¸âƒ£ 9ï¸âƒ£
sign	ã€½ï¸ âŒ¨ â¾ â–ªï¸ â–«ï¸ â—»ï¸ â—¼ï¸ â—½ï¸ â—¾ï¸ â˜ â˜‘ï¸ â˜’ â˜¢ â˜£ â˜® â˜¯ â™² â™¾ âšªï¸ âš«ï¸ âœ… âœ”ï¸ âœ• âœ–ï¸ âœ— âœ˜ âœ¨ âœ³ï¸ âœ´ï¸ â‡ï¸ âŒ â â• â– â— â° â¿ â¬›ï¸ â¬œï¸ ğŸ’  ğŸ”… ğŸ”† ğŸ”˜ ğŸ”² ğŸ”³ ğŸ”´ ğŸ”µ ğŸ”¶ ğŸ”· ğŸ”¸ ğŸ”¹ ğŸ”º ğŸ”» ğŸ”¾ ğŸ”¿ ğŸ—™ ã€  ğŸ…¿ ğŸ›‚ ğŸ›ƒ ğŸ›„ ğŸ›… ğŸš° â™¿ ğŸš¹ ğŸšº ğŸš» ğŸš¼ ğŸš¾ ğŸ† ğŸš­ ğŸš³ ğŸš± ğŸš· ğŸš¯ ğŸš¸  
animal	ğŸ€ ğŸ ğŸ‚ ğŸƒ ğŸ„ ğŸ… ğŸ† ğŸ‡ ğŸˆ ğŸ‰ ğŸŠ ğŸ‹ ğŸŒ ğŸ ğŸ ğŸ ğŸ ğŸ‘ ğŸ’ ğŸ“ ğŸ” ğŸ• ğŸ– ğŸ— ğŸ˜ ğŸ™ ğŸš ğŸ› ğŸœ ğŸ ğŸ ğŸŸ ğŸ  ğŸ¡ ğŸ¢ ğŸ£ ğŸ¤ ğŸ¥ ğŸ¦ ğŸ§ ğŸ¨ ğŸ© ğŸª ğŸ« ğŸ¬ ğŸ­ ğŸ® ğŸ¯ ğŸ° ğŸ± ğŸ² ğŸ³ ğŸ´ ğŸµ ğŸ¶ ğŸ· ğŸ¸ ğŸ¹ ğŸº ğŸ» ğŸ¼ ğŸ½ ğŸ¾ ğŸ¿ ğŸ‘½ ğŸ‘¾ ğŸ•Š ğŸ•· ğŸ•¸ ğŸ˜¸ ğŸ˜¹ ğŸ˜º ğŸ˜» ğŸ˜¼ ğŸ˜½ ğŸ˜¾ ğŸ˜¿ ğŸ™€
food	ğŸ… ğŸ† ğŸ‡ ğŸˆ ğŸ‰ ğŸŠ ğŸ‹ ğŸŒ ğŸ ğŸ ğŸ ğŸ ğŸ‘ ğŸ’ ğŸ“ ğŸ” ğŸ• ğŸ– ğŸ— ğŸ˜ ğŸ™ ğŸš ğŸ› ğŸœ ğŸ ğŸ ğŸŸ ğŸ  ğŸ¡ ğŸ¢ ğŸ£ ğŸ¤ ğŸ¥ ğŸ¦ ğŸ§ ğŸ¨ ğŸ© ğŸª ğŸ« ğŸ¬ ğŸ­ ğŸ® ğŸ¯ ğŸ° ğŸ± ğŸ² ğŸ³ ğŸ´ ğŸ½
plant	â¸™ â˜˜ ğŸŒ° ğŸŒ± ğŸŒ² ğŸŒ³ ğŸŒ´ ğŸŒµ ğŸŒ¶ ğŸŒ· ğŸŒ¸ ğŸŒ¹ ğŸŒº ğŸŒ» ğŸŒ¼ ğŸŒ½ ğŸŒ¾ ğŸŒ¿ ğŸ€ ğŸ ğŸ‚ ğŸƒ ğŸ„ ğŸ… ğŸ† ğŸ‡ ğŸˆ ğŸ‰ ğŸŠ ğŸ‹ ğŸŒ ğŸ ğŸ ğŸ ğŸ ğŸ‘ ğŸ’ ğŸ“ ğŸ•

vehicle	ğŸš€ ğŸš ğŸš‚ ğŸšƒ ğŸš„ ğŸš… ğŸš† ğŸš‡ ğŸšˆ ğŸš‰ ğŸšŠ ğŸš‹ ğŸšŒ ğŸš ğŸš ğŸš ğŸš‘ ğŸš’ ğŸš“ ğŸš” ğŸš• ğŸš– ğŸš— ğŸš˜ ğŸš™ ğŸšš ğŸš› ğŸšœ ğŸš ğŸš ğŸšŸ ğŸš  ğŸš¡ ğŸš¢ ğŸš£ ğŸš¤ ğŸ›¥ ğŸ›¦ ğŸ›§ ğŸ›¨ ğŸ›© ğŸ›ª ğŸ›« ğŸ›¬ ğŸ›° ğŸ›± ğŸ›² ğŸ›³
creature	ğŸ‘¹ ğŸ‘º ğŸ‘» ğŸ‘½ ğŸ‘¾  
computer	ğŸ’» ğŸ–¥ ğŸ–¦ ğŸ–§ ğŸ–¨ ğŸ–© ğŸ–®âŒ¨  ğŸ–¯ ğŸ–° ğŸ–± ğŸ–² ğŸ–³ ğŸ–´ ğŸ–µ ğŸ–¶ ğŸ–· ğŸ–¸ğŸ–³ ğŸ’½ ğŸ’¾ ğŸ’¿ ğŸ“€ğŸ—” ğŸ—• ğŸ—– ğŸ——
lock	 ğŸ”’ ğŸ”“ğŸ” ğŸ” ğŸ”‘ğŸ—âš¿ 
tool	 ğŸ”¨â› âš’âš’ğŸ› ğŸ”§ ğŸ”©âš™ğŸ—œ âš—âš–ğŸ’‰
weapon	ğŸ—¡ğŸ”ª âš” ğŸ”«ğŸ›¡â›¨
geometric	ï¸   â–ªï¸ â–«ï¸ â—»ï¸ â—¼ï¸ â—½ï¸ â—¾ï¸ â˜     â¬›ï¸ â¬œï¸ ğŸ”¶ ğŸ”· ğŸ”¸ ğŸ”¹ ğŸ”º ğŸ”» ğŸ’   ğŸ”˜ ğŸ”² ğŸ”³âšªï¸ âš«ï¸ ğŸ”´ ğŸ”µ ğŸ”¾ ğŸ”¿

punctuation	 â€¼ï¸ â‰ï¸
 â“ â” â• â—ï¸ â¢ ã€° â£
fruit	ğŸ‡ ğŸˆ ğŸ‰ ğŸŠ ğŸ‹ ğŸŒ ğŸ ğŸ ğŸ ğŸ ğŸ‘ ğŸ’ ğŸ“
sweet, dessert	ğŸ¡ ğŸ¦ ğŸ§ ğŸ¨ ğŸ© ğŸª  ğŸ‚ğŸ°
ğŸ« ğŸ¬ ğŸ­ ğŸ® 
sweet	ğŸ¯ 

+1	ğŸ‘
-1	ğŸ‘
100	ğŸ’¯
1234	ğŸ”¢
8 ball	ğŸ±
a	ğŸ…°
ab	ğŸ†
abc	ğŸ”¤
abcd	ğŸ”¡
airplane	âœˆ
alien	ğŸ‘½
ambulance	ğŸš‘
anchor	âš“
angel	ğŸ‘¼
anger	ğŸ’¢
angry	ğŸ˜ 
anguished	ğŸ˜§
ant	ğŸœ
apple	ğŸ
aquarius	â™’
aries	â™ˆ
art	ğŸ¨
astonished	ğŸ˜²
atm	ğŸ§
b	ğŸ…±
baby	ğŸ‘¶
back	ğŸ”™
balloon	ğŸˆ
bamboo	ğŸ
banana	ğŸŒ
bangbang	â€¼
bank	ğŸ¦
barber	ğŸ’ˆ
baseball	âš¾
basketball	ğŸ€
bath	ğŸ›€
bathtub	ğŸ›
battery	ğŸ”‹
bear	ğŸ»
bee	ğŸ
beer	ğŸº ğŸ»
lady beetle, ladybug, ladybird	ğŸ
beginner	ğŸ”°
bell	ğŸ””
bento	ğŸ±
cyclist	ğŸš´
bike	ğŸš²
bikini	ğŸ‘™
bird	ğŸ¦
birthday	ğŸ‚
blossom	ğŸŒ¼
blowfish	ğŸ¡
blush	ğŸ˜Š
boar	ğŸ—
boat	â›µ
bomb	ğŸ’£
book	ğŸ“– ğŸ“š
bookmark	ğŸ”–
boom	ğŸ’¥
boot,shoe	ğŸ‘¢
bouquet	ğŸ’
bow	ğŸ™‡
bowling	ğŸ³
boy	ğŸ‘¦
bread	ğŸ
briefcase	ğŸ’¼
bug	ğŸ›
bulb	ğŸ’¡
bus	ğŸšŒ
busstop	ğŸš
cactus	ğŸŒµ
cake	ğŸ°
calendar	ğŸ“†
call	ğŸ“²
camel	ğŸ«
camera	ğŸ“·
cancer	â™‹
candy	ğŸ¬
capricorn	â™‘
car	ğŸš—
cat	ğŸ±
cd	ğŸ’¿
chart	ğŸ’¹
cherry	ğŸ’
chestnut	ğŸŒ°
chicken	ğŸ”
church	â›ª
cinema	ğŸ¦
cl	ğŸ†‘
clap	ğŸ‘
clapper	ğŸ¬
clipboard	ğŸ“‹
10:00	ğŸ•™
10:30	ğŸ•¥
11:00	ğŸ•š
11:30	ğŸ•¦
12:00	ğŸ•›
12:30	ğŸ•§
1:00	ğŸ•
1:30	ğŸ•œ
2:00	ğŸ•‘
2:30	ğŸ•
3:00	ğŸ•’
3:30	ğŸ•
4:00	ğŸ•“
4:30	ğŸ•Ÿ
5:00	ğŸ•”
5:30	ğŸ• 
6:00	ğŸ••
6:30	ğŸ•¡
7:00	ğŸ•–
7:30	ğŸ•¢
8:00	ğŸ•—
8:30	ğŸ•£
9:00	ğŸ•˜
9:30	ğŸ•¤
00, oâ€™clock	ğŸ•™
00, oâ€™clock	ğŸ•š
00, oâ€™clock	ğŸ•›
00, oâ€™clock	ğŸ•
00, oâ€™clock	ğŸ•‘
00, oâ€™clock	ğŸ•’
00, oâ€™clock	ğŸ•“
00, oâ€™clock	ğŸ•”
00, oâ€™clock	ğŸ••
00, oâ€™clock	ğŸ•–
00, oâ€™clock	ğŸ•—
00, oâ€™clock	ğŸ•˜
00, oâ€™clock	ğŸ•
00, oâ€™clock	ğŸ•‘
00, oâ€™clock	ğŸ•’
00, oâ€™clock	ğŸ•“
00, oâ€™clock	ğŸ•”
00, oâ€™clock	ğŸ••
00, oâ€™clock	ğŸ•–
00, oâ€™clock	ğŸ•—
00, oâ€™clock	ğŸ•˜
cloud	â˜
clubs	â™£
cocktail	ğŸ¸
coffee	â˜•
collision	ğŸ’¥
computer	ğŸ’»
confounded	ğŸ˜–
confused	ğŸ˜•
congratulations	ãŠ—
construction	ğŸš§
cookie	ğŸª
cool	ğŸ†’
cop	ğŸ‘®
copyright,symbol	Â© â„—
corn	ğŸŒ½
couple	ğŸ‘« ğŸ’ ğŸ‘¬ ğŸ‘­ ğŸ’
cow	ğŸ®
crocodile	ğŸŠ
crown	ğŸ‘‘
cry	ğŸ˜¢
cupid,romance	ğŸ’˜
curry	ğŸ›
custard	ğŸ®
customs	ğŸ›ƒ
cyclone	ğŸŒ€
dancer	ğŸ’ƒ
dancer	ğŸ‘¯
dango	ğŸ¡
dart	ğŸ¯
dash	ğŸ’¨
date	ğŸ“…
disappointed	ğŸ˜
dizzy	ğŸ’«
dog	ğŸ¶
dollar	ğŸ’µ
dolphin	ğŸ¬
door	ğŸšª
doughnut,pastry	ğŸ©
dragon,fairy tale	ğŸ‰
dress	ğŸ‘—
drop	ğŸ’§
dvd	ğŸ“€
e-mail	ğŸ“§
ear	ğŸ‘‚
egg	ğŸ³
eggplant	ğŸ†
elephant	ğŸ˜
email,e-mail	âœ‰
end	ğŸ”š
envelope	âœ‰
euro	ğŸ’¶
exclamation	â—
expressionless	ğŸ˜‘
eyeglasses	ğŸ‘“
facepunch	ğŸ‘Š
factory	ğŸ­
family	ğŸ‘ª
fax	ğŸ“ 
fearful	ğŸ˜¨
feet	ğŸ¾
fire	ğŸ”¥
fireworks	ğŸ†
fish	ğŸŸ ğŸ¡
fist	âœŠ
flag	ğŸ
flashlight	ğŸ”¦
flipper	ğŸ¬
flushed	ğŸ˜³
fog	ğŸŒ
football	ğŸˆ
footprint	ğŸ‘£
fountain	â›²
free	ğŸ†“
fries	ğŸŸ
frog	ğŸ¸
frown	ğŸ˜¦
fuelpump	â›½
gem	ğŸ’
gemini	â™Š
ghost	ğŸ‘»
gift,box	ğŸ
girl	ğŸ‘§
goat	ğŸ
golf	â›³
grape	ğŸ‡
grimace	ğŸ˜¬
grin	ğŸ˜ ğŸ˜€
guardsman	ğŸ’‚
guitar	ğŸ¸
gun	ğŸ”«
haircut	ğŸ’‡
hamburger	ğŸ”
hammer	ğŸ”¨
hamster	ğŸ¹
hand	âœ‹
handbag	ğŸ‘œ
hankey	ğŸ’©
headphone,earbud	ğŸ§
heart	â¤
heartbeat	ğŸ’“
heartpulse	ğŸ’—
helicopter	ğŸš
herb	ğŸŒ¿
hibiscus	ğŸŒº
hocho	ğŸ”ª
honeybee	ğŸ
horse	ğŸ´
hospital,medicine	ğŸ¥
hotel	ğŸ¨
hotsprings	â™¨
hourglass	âŒ›
house	ğŸ 
hushed	ğŸ˜¯
icecream	ğŸ¦
i	â„¹  ğŸ›ˆ
id	ğŸ†”
imp	ğŸ‘¿
innocent	ğŸ˜‡
interrobang	â‰
iphone	ğŸ“±
japan	ğŸ—¾
jeans	ğŸ‘–
joy	ğŸ˜‚
key	ğŸ”‘
kimono	ğŸ‘˜
kiss	 ğŸ’‹ ğŸ’ ğŸ˜—
koala	ğŸ¨
lantern,light	ğŸ®
laugh	ğŸ˜†
leaf	ğŸƒ
ledger	ğŸ“’
lemon	ğŸ‹
leo	â™Œ
leopard	ğŸ†
libra	â™
link	ğŸ”—
lips	ğŸ‘„
lipstick	ğŸ’„
lock	ğŸ”’
lollipop	ğŸ­
loop	â¿
loudspeaker	ğŸ“¢
m	â“‚
mahjong	ğŸ€„
mailbox	ğŸ“«
man	ğŸ‘¨
mask	ğŸ˜·
massage	ğŸ’†
megaphone	ğŸ“£
melon	ğŸˆ
memo	ğŸ“
menâ€™s	ğŸš¹
metro	ğŸš‡
microphone	ğŸ¤
microscope	ğŸ”¬
minibus	ğŸš
minidisc	ğŸ’½
moneybag	ğŸ’°
monkey	ğŸ’
monorail	ğŸš
moon	ğŸŒ”
mouse	ğŸ­
moyai	ğŸ—¿
muscle	ğŸ’ª
mushroom	ğŸ„
mute	ğŸ”‡ ğŸ”•
necktie	ğŸ‘”
new	ğŸ†•
newspaper	ğŸ“°
ng	ğŸ†–
nose	ğŸ‘ƒ
notebook	ğŸ““
notes	ğŸ¶
o	â­•
o	ğŸ…¾
ocean	ğŸŒŠ
octopus	ğŸ™
oden	ğŸ¢
office	ğŸ¢
ok	ğŸ†—
on	ğŸ”›
ophiuchus	â›
ox	ğŸ‚
package	ğŸ“¦
pager	ğŸ“Ÿ
paperclip	ğŸ“
parking	ğŸ…¿
peach	ğŸ‘
pear	ğŸ
pencil	ğŸ“
penguin	ğŸ§
pensive	ğŸ˜”
persevere	ğŸ˜£
phone	â˜
pig	ğŸ·
pill	ğŸ’Š
pineapple	ğŸ
pisces	â™“
pizza	ğŸ•
poodle,dog	ğŸ©
poop	ğŸ’©
postbox	ğŸ“®
pouch	ğŸ‘
pound	ğŸ’·
pray	ğŸ™
princess	ğŸ‘¸
punch	ğŸ‘Š
purse	ğŸ‘›
pushpin	ğŸ“Œ
question	â“
rabbit	ğŸ°
racehorse,racing	ğŸ
radio	ğŸ“»
rage	ğŸ˜¡
rainbow	ğŸŒˆ
ram	ğŸ
ramen	ğŸœ
rat	ğŸ€
recycle	â™»
registered	Â®
relaxed	â˜º
relieved	ğŸ˜Œ
repeat	ğŸ”
restroom	ğŸš»
rewind	âª
ribbon	ğŸ€
rice	ğŸš
ring	ğŸ’
rocket	ğŸš€
rooster	ğŸ“
rose	ğŸŒ¹
rowboat	ğŸš£
runner	ğŸƒ
running	ğŸƒ
sagittarius	â™
sailboat	â›µ
sake	ğŸ¶
sandal	ğŸ‘¡
santa	ğŸ…
satellite	ğŸ“¡
satisfied	ğŸ˜†
saxophone	ğŸ·
school	ğŸ«
scissors	âœ‚
scorpius	â™
scream	ğŸ˜±
scroll	ğŸ“œ
seat	ğŸ’º
secret	ãŠ™
seedling	ğŸŒ±
sheep	ğŸ‘
shell	ğŸš
ship	ğŸš¢
shirt	ğŸ‘•
dung	ğŸ’©
shoe	ğŸ‘
shower	ğŸš¿
ski	ğŸ¿
skull	ğŸ’€
sleep	ğŸ˜´ ğŸ˜ª
smile	ğŸ˜„
smiley	ğŸ˜ƒ
smirk	ğŸ˜
smoking	ğŸš¬
snail	ğŸŒ
snake	ğŸ
snowflake	â„
snowman	â›„
sob	ğŸ˜­
soccer	âš½
soon	ğŸ”œ
sos	ğŸ†˜
sound	ğŸ”‰
spade	â™ 
spaghetti	ğŸ
sparkle	â‡ ğŸ‡ âœ¨
speaker	ğŸ”Š
speedboat	ğŸš¤
star	â­ ğŸŒƒ
station	ğŸš‰
stew	ğŸ²
strawberry	ğŸ“
sunflower	ğŸŒ»
sunglasses	ğŸ˜
sunny	â˜€
sunrise	ğŸŒ…
surfer	ğŸ„
sushi	ğŸ£
sweat	ğŸ˜“
swim	ğŸŠ
symbols	ğŸ”£
syringe	ğŸ’‰
tada	ğŸ‰
tangerine	ğŸŠ
taurus	â™‰
taxi	ğŸš•
tea	ğŸµ
telephone	â˜
telescope	ğŸ”­
tennis	ğŸ¾
tent	â›º
thumbâ€™s down	ğŸ‘
thumbsâ€™s up	ğŸ‘
ticket	ğŸ«
tiger	ğŸ¯
tm	â„¢
toilet	ğŸš½
tomato	ğŸ…
tongue	ğŸ‘…
top	ğŸ”
tophat	ğŸ©
tractor	ğŸšœ
train	ğŸšƒ
tram	ğŸšŠ
trident	ğŸ”±
triumph	ğŸ˜¤
trolleybus	ğŸš
trophy	ğŸ†
truck	ğŸšš
trumpet	ğŸº
tshirt	ğŸ‘•
tulip	ğŸŒ·
turtle	ğŸ¢
tv,entertainment	ğŸ“º
umbrella	â˜”
unamused	ğŸ˜’
underage	ğŸ”
unlock	ğŸ”“
up	ğŸ†™
v	âœŒ
vhs	ğŸ“¼
violin	ğŸ»
virgo	â™
volcano	ğŸŒ‹
vs	ğŸ†š
walk	ğŸš¶
warning	âš 
watch	âŒš
watermelon	ğŸ‰
wc	ğŸš¾
weary	ğŸ˜©
wedding	ğŸ’’
whale	ğŸ³
wheelchair	â™¿
wink	ğŸ˜‰
wolf	ğŸº
woman	ğŸ‘©
womenâ€™s	ğŸšº
worried	ğŸ˜Ÿ
wrench	ğŸ”§
x	âŒ
yen	ğŸ’´
yum	ğŸ˜‹
zap	âš¡
zzz	ğŸ’¤
human	â˜º  â˜¹  â˜»  ğŸ™  ğŸ™‚  ğŸ˜€  ğŸ˜  ğŸ˜‚ 
ğŸ˜ƒ  ğŸ˜„  ğŸ˜…  ğŸ˜†  ğŸ˜‰  ğŸ˜Š  ğŸ˜‹  ğŸ˜Œ 
ğŸ˜  ğŸ˜  ğŸ˜  ğŸ˜  ğŸ˜‘  ğŸ˜’  ğŸ˜“  ğŸ˜” 
ğŸ˜•  ğŸ˜–  ğŸ˜—  ğŸ˜˜  ğŸ˜™  ğŸ˜š  ğŸ˜›  ğŸ˜œ 
ğŸ˜  ğŸ˜  ğŸ˜Ÿ  ğŸ˜   ğŸ˜¡  ğŸ˜¢  ğŸ˜£  ğŸ˜¤ 
ğŸ˜¥  ğŸ˜¦  ğŸ˜§  ğŸ˜¨  ğŸ˜©  ğŸ˜ª  ğŸ˜«  ğŸ˜¬ 
ğŸ˜­  ğŸ˜®  ğŸ˜¯  ğŸ˜°  ğŸ˜±  ğŸ˜²  ğŸ˜³  ğŸ˜´ 
ğŸ˜µ  ğŸ˜¶  ğŸ˜·  ğŸ˜‡  ğŸ‘¼  ğŸ˜ˆ  ğŸ‘¿  ã€ 
ğŸ‘¦  ğŸ‘§  ğŸ‘¨  ğŸ‘©  ğŸ‘®  ğŸ‘±  ğŸ‘²  ğŸ‘³ 
ğŸ‘´  ğŸ‘µ  ğŸ‘¶  ğŸ‘·  ğŸ‘¸  ğŸ’  ğŸ’‚   
ğŸ•µ  ğŸ‘¯  ğŸ’†  ğŸ’‡  ğŸ’  ğŸ’‘  ğŸ‘°  ğŸ™ 
ğŸ™  ğŸ™…  ğŸ™†  ğŸ™‡  ğŸ™‹  ğŸ™Œ  ğŸ™  ğŸ—£ 
ğŸ‘¤  ğŸ‘¥  ğŸ›‰  ğŸ›Š  ğŸš¶  ğŸƒ  ğŸ’ƒ  ğŸ•´ 
ğŸ‘ª  ğŸ‘«  ğŸ‘¬  ğŸ‘­
ğŸ‘ˆ  â˜š  â˜œ  ğŸ–š  ğŸ–˜  ğŸ–œ  ğŸ‘‰  â˜› 
â˜  ğŸ–  ğŸ–›  ğŸ–™  â˜  ğŸ–¢  ğŸ–  ğŸ–  
ğŸ‘†  ğŸ–•  â˜Ÿ  ğŸ–—  ğŸ–£  ğŸ–Ÿ  ğŸ–¡  ğŸ‘‡ 
âœŒ  ğŸ–”  ğŸ––  âœŠ  âœ‹  ğŸ‘Š  ğŸ‘‹  ğŸ‘Œ 
ğŸ‘  ğŸ–’  ğŸ‘  ğŸ–“  ğŸ‘  ğŸ‘  âœ  ğŸ– 
ğŸ–  ğŸ–  ğŸ–‘  ğŸ’…  ğŸ’ª  ğŸ‘£  
ğŸ‘‚  ğŸ‘ƒ  ğŸ‘…  ğŸ’‹  ğŸ‘„  ğŸ—¢ 
ğŸš·  ğŸš¸  â™¿  ğŸš¹  ğŸšº 
ğŸš»  ğŸš¼ğŸš®ğŸŒ â›·  ğŸ‚  ğŸ„  ğŸ‡  ğŸŠ  â›¹  ğŸ‹ğŸ…ğŸš´ ğŸšµğŸ
shinto, shrine	â›©
fantasy	ğŸ˜‡  ğŸ‘¼  ğŸ˜ˆ  ğŸ‘¿ğŸ‘¸ğŸ‘¹  ğŸ‘º  ğŸ‘»  ğŸ‘½  ğŸ‘¾ğŸš€ğŸ…ğŸ”®
barrier	ğŸš§
pet	ğŸ• ğŸ¶ ğŸˆ ğŸ± ğŸ¹ ğŸ° ğŸ‡
intercardinal,direction	â†˜ â†™ â†— â†–
cardinal,direction	â¡ï¸ï¸ â¬…ï¸ â¬†ï¸ â¬‡ï¸
south	â¬‡ï¸
north	â¬†ï¸ 
west	â¬…ï¸
east	â¡ï¸ï¸ 
education	ğŸ’ ğŸ« ğŸ“ ğŸ“”  ğŸ“•  ğŸ“–  ğŸ“—  ğŸ“˜  ğŸ“™  ğŸ“š  ğŸ•® âœ  ğŸ–
insect	ğŸ›  ğŸœ  ğŸ  ğŸ  ğŸ•·
math	âœ• â• â– â—   	


















































