#Draft Emoji Annotations

#Finer-grained character annotations. For brevity, flags are not shown: they would have names of the associated countries. For details about the format and other information, see Unicode Emoji.

0, zero	0âƒ£
1, one	â›•  ğŸ•  ğŸ•œ  1âƒ£  ğŸ–¯
2, two	ğŸ•‘  ğŸ•  2âƒ£  ğŸ–°
3, three	ğŸ—¤  ğŸ—¥  ğŸ—¦  ğŸ—§  ğŸ—«  ğŸ•’  ğŸ•  ğŸ”Š  ğŸ•ª  3âƒ£  ğŸ–§  ğŸ–±
4, four	ğŸ€  ğŸ•“  ğŸ•Ÿ  4âƒ£
5, five	ğŸ•”  ğŸ•   5âƒ£
6, six	ğŸ••  ğŸ•¡  6âƒ£
7, seven	ğŸ•–  ğŸ•¢  7âƒ£
8, eight	ğŸ•—  ğŸ•£  ğŸ±  8âƒ£
9, nine	ğŸ•˜  ğŸ•¤  9âƒ£
-1, thumbâ€™s down	ğŸ‘
00, oâ€™clock	ğŸ•›  ğŸ•  ğŸ•‘  ğŸ•’  ğŸ•“  ğŸ•”  ğŸ••  ğŸ•–  ğŸ•—  ğŸ•˜  ğŸ•™  ğŸ•š
10, ten	ğŸ•™  ğŸ•¥  ğŸ”Ÿ
11, eleven	ğŸ•š  ğŸ•¦
12, twelve	ğŸ•›  ğŸ•§
18, eighteen, underage	ğŸ”
30, thirty	ğŸ•§  ğŸ•œ  ğŸ•  ğŸ•  ğŸ•Ÿ  ğŸ•   ğŸ•¡  ğŸ•¢  ğŸ•£  ğŸ•¤  ğŸ•¥  ğŸ•¦
100, hundred	ğŸ’¯
1234, numbers	ğŸ”¢
+1, thumbsâ€™s up	ğŸ‘
1:00	ğŸ•
1:30	ğŸ•œ
2:00	ğŸ•‘
2:30	ğŸ•
3:00	ğŸ•’
3:30	ğŸ•
4:00	ğŸ•“
4:30	ğŸ•Ÿ
5:00	ğŸ•”
5:30	ğŸ• 
6:00	ğŸ••
6:30	ğŸ•¡
7:00	ğŸ•–
7:30	ğŸ•¢
8 ball, billiard	ğŸ±
8:00	ğŸ•—
8:30	ğŸ•£
9:00	ğŸ•˜
9:30	ğŸ•¤
10:00	ğŸ•™
10:30	ğŸ•¥
11:00	ğŸ•š
11:30	ğŸ•¦
12:00	ğŸ•›
12:30	ğŸ•§
a	ğŸ…°
ab	ğŸ†
abc, alphabet	ğŸ”¤
abcd, lowercase	ğŸ”¡
above	ğŸ—¤  ğŸ“©  ğŸ”™  ğŸ”š  ğŸ”›  ğŸ”œ  ğŸ”
access, wheelchair	â™¿
activity	ğŸ…  ğŸ©  ğŸ’’  ğŸ   ğŸ¡  ğŸ¢  ğŸª  ğŸ«  ğŸ­  ğŸ°  ğŸŒ   ğŸ¼  ğŸµ  ğŸ¶  ğŸ¤  ğŸ§ 
ğŸ·  ğŸ¸  ğŸ¹  ğŸº  ğŸ»  ğŸ¥  ğŸ¦  ğŸ¬  ğŸƒ  ğŸ„  ğŸ†  ğŸ‡  ğŸˆ  ğŸ‰  ğŸŠ  ğŸ‹ 
ğŸŒ  ğŸ  ğŸ  ğŸ  ğŸ  ğŸ‘  ğŸ“  ğŸ¨  ğŸ¯  ğŸ´  ğŸ’  ğŸš¬
address, loudspeaker, public	ğŸ“¢
administrative, macao, macau, special	ğŸ‡²ğŸ‡´
admission, ticket	ğŸ«  ğŸŸ
aerial, ropeway, tramway	ğŸš¡
aesculapius	âš•
afghanistan	ğŸ‡¦ğŸ‡«
africa	ğŸŒ  ğŸ‡¿ğŸ‡¦
african, central	ğŸ‡¨ğŸ‡«
airplane	âœˆ  ğŸ›¦  ğŸ›§  ğŸ›¨  ğŸ›©  ğŸ›ª  ğŸ›«  ğŸ›¬
Ã¥land	ğŸ‡¦ğŸ‡½
alarm	â°
albania	ğŸ‡¦ğŸ‡±
alembic, chemistry	âš—
alert, rounded	ğŸ›†
algeria	ğŸ‡©ğŸ‡¿
alien, ufo	ğŸ‘½  ğŸ‘¾
allowed, permitted	ğŸš¬
alternate	â›•
ambulance	ğŸš‘
america, u.s.a., us, usa	ğŸ‡ºğŸ‡¸
american	ğŸˆ  ğŸ‡¦ğŸ‡¸
americas	ğŸŒ
amusement park	ğŸ¡  ğŸ¢
anchor	âš“  ğŸ”±
andorra	ğŸ‡¦ğŸ‡©
angel	ğŸ˜‡  ğŸ‘¼
anger, angry	ğŸ˜   ğŸ˜¡  ğŸ’¢  ğŸ—®  ğŸ—¯
angola	ğŸ‡¦ğŸ‡´
anguilla	ğŸ‡¦ğŸ‡®
anguished	ğŸ˜§
animal	ğŸµ  ğŸ’  ğŸ¶  ğŸ•  ğŸ©  ğŸº  ğŸ±  ğŸ˜¸  ğŸ˜¹  ğŸ˜º  ğŸ˜»  ğŸ˜¼  ğŸ˜½  ğŸ˜¾  ğŸ˜¿  ğŸ™€ 
ğŸˆ  ğŸ¯  ğŸ…  ğŸ†  ğŸ´  ğŸ  ğŸ®  ğŸ‚  ğŸƒ  ğŸ„  ğŸ·  ğŸ–  ğŸ—  ğŸ½  ğŸ  ğŸ‘ 
ğŸ  ğŸª  ğŸ«  ğŸ˜  ğŸ­  ğŸ  ğŸ€  ğŸ¹  ğŸ°  ğŸ‡  ğŸ¿  ğŸ»  ğŸ¨  ğŸ¼  ğŸ¾  ğŸ” 
ğŸ“  ğŸ£  ğŸ¤  ğŸ¥  ğŸ¦  ğŸ§  ğŸ•Š  ğŸ¸  ğŸŠ  ğŸ  ğŸ¢  ğŸ²  ğŸ‰  ğŸ³  ğŸ‹  ğŸ¬ 
ğŸŸ  ğŸ   ğŸ¡  ğŸ™  ğŸš  ğŸŒ  ğŸ›  ğŸœ  ğŸ  ğŸ  ğŸ•·  ğŸ•¸  ğŸ‘½  ğŸ‘¾  ğŸ’
ant	ğŸœ
antarctica	ğŸ‡¦ğŸ‡¶
antenna	ğŸ“¶  ğŸ“¡
anticlockwise	ğŸ”„
antigua, barbuda	ğŸ‡¦ğŸ‡¬
antilles, curacao, curaÃ§ao	ğŸ‡¨ğŸ‡¼
apology, bow, sorry	ğŸ™‡
apple	ğŸ  ğŸ
aquarius	â™’
arab	ğŸ‡ªğŸ‡¬  ğŸ‡±ğŸ‡¾  ğŸ‡¸ğŸ‡¾  ğŸ‡¦ğŸ‡ª
arabia, saudi	ğŸ‡¸ğŸ‡¦
argentina	ğŸ‡¦ğŸ‡·
aries	â™ˆ
armenia	ğŸ‡¦ğŸ‡²
arrivals, arriving	ğŸ›¬
arrow	ğŸ’˜  ğŸ”€  ğŸ”  ğŸ”‚  â–¶  âµ  â©  â­  â¯  â—€  â´  âª  â®  ğŸ”¼  â¶  â« 
ğŸ”½  â¬  ğŸ“²  ğŸ“©  â¬†  â†—  â¡  â†˜  â¬‡  â†™  â¬…  â†–  â†•  â†”  â†©  â†ª 
â¤´  â¤µ  ğŸ”ƒ  ğŸ”„  ğŸ—˜  ğŸ”™  ğŸ”š  ğŸ”›  ğŸ”œ  ğŸ”
art	ğŸ­  ğŸ¨
artist, paint, palette	ğŸ¨
aruba	ğŸ‡¦ğŸ‡¼
ascending	ğŸœ
ascension	ğŸ‡¦ğŸ‡¨  ğŸ‡¸ğŸ‡­
asia	ğŸŒ
ask, folded, please, pray, prayer, praying, thanks	ğŸ™
asterisk	*âƒ£  âœ³
astonished, shocked, totally	ğŸ˜²
atheist, atom	âš›
athletic, sneaker	ğŸ‘Ÿ
atm, automated, teller	ğŸ§
aubergine, eggplant	ğŸ†
australia	ğŸŒ  ğŸ‡¦ğŸ‡º
austria	ğŸ‡¦ğŸ‡¹
automobile	ğŸš—  ğŸš˜
azerbaijan	ğŸ‡¦ğŸ‡¿
b	ğŸ…±
baby	ğŸ‘¶  ğŸ‘¼  ğŸ£  ğŸ¤  ğŸ¥  ğŸ¼  ğŸš¼
back	ğŸ–‚  ğŸ”™
backhand	ğŸ‘ˆ  ğŸ–œ  ğŸ‘‰  ğŸ–  ğŸ–¢  ğŸ‘†  ğŸ–£  ğŸ‘‡
bactrian	ğŸ«
badge, name	ğŸ“›
bag	ğŸ‘œ  ğŸ‘  ğŸ›  ğŸ’°  ğŸ’
baggage	ğŸ›„  ğŸ›…
bahamas	ğŸ‡§ğŸ‡¸
bahrain	ğŸ‡§ğŸ‡­
balance, justice, scales	âš–
ball	ğŸ™  âš½  âš¾  ğŸ€  ğŸˆ  ğŸ‰  ğŸ¾  ğŸ±  ğŸ³  ğŸŒ  â›¹  ğŸŠ  ğŸ”®
balloon	ğŸ’¬  ğŸ’­  ğŸ—¨  ğŸ—©  ğŸ—ª  ğŸ—«  ğŸ—¬  ğŸ—­  ğŸ—®  ğŸ—¯  ğŸ—°  ğŸ—±  ğŸˆ
ballot	ğŸ—³  â˜‘  âœ—  âœ˜  â˜’  â˜
ballpoint	ğŸ–Š
bamboo, pine	ğŸ
banana	ğŸŒ
bangbang	â€¼
bangladesh	ğŸ‡§ğŸ‡©
bank	ğŸ¦  ğŸ’´  ğŸ’µ  ğŸ’¶  ğŸ’·  ğŸ’¸  ğŸ‡µğŸ‡¸
banknote, bill	ğŸ’´  ğŸ’µ  ğŸ’¶  ğŸ’·  ğŸ’¸
banner	ğŸ‹
bar	ğŸ«  ğŸ¶  ğŸ·  ğŸ¸  ğŸ¹  ğŸº  ğŸ»  â¸  ğŸ®  ğŸ“Š
barbados	ğŸ‡§ğŸ‡§
barber	ğŸ’‡  ğŸ’ˆ
barrier	ğŸš§
bars	ğŸ“¶
barthelemy, barthÃ©lemy	ğŸ‡§ğŸ‡±
baseball	âš¾
basketball, hoop	ğŸ€
bath, bathtub	ğŸ›€  ğŸ›
battery	ğŸ”‹
beach	ğŸ–
beacon	ğŸš¨
beamed	ğŸœ  ğŸ  â™«  â™¬
bear	ğŸ»  ğŸ¨
beating, heartbeat, pulsating	ğŸ’“
beauty, haircut, parlor	ğŸ’‡
bed	ğŸ›
bee, honeybee	ğŸ
beer	ğŸº  ğŸ»
beers, clinking, mugs	ğŸ»
beetle, lady	ğŸ
beginner, chevron	ğŸ”°
belarus	ğŸ‡§ğŸ‡¾
belgium	ğŸ‡§ğŸ‡ª
belize	ğŸ‡§ğŸ‡¿
bell	ğŸ›  ğŸ””  ğŸ”•  ğŸ•­
bellhop	ğŸ›
below	ğŸ—¥
benin	ğŸ‡§ğŸ‡¯
bento	ğŸ±
bermuda	ğŸ‡§ğŸ‡²
berry, strawberry	ğŸ“
beverage, coffee	â˜•
bhutan	ğŸ‡§ğŸ‡¹
biceps, flex, muscle	ğŸ’ª
bicycle, bicycling, bike, biking	ğŸš²  ğŸš³  ğŸš´  ğŸšµ
bicyclist, cyclist	ğŸš´  ğŸšµ
bikini	ğŸ‘™
biohazard	â˜£
bird	ğŸ¦
birthday	ğŸ‚
bissau	ğŸ‡¬ğŸ‡¼
black	â—ª  â—
blond	ğŸ‘±
blood	ğŸ…°  ğŸ†  ğŸ…±  ğŸ…¾
blossom	ğŸŒ¸  ğŸŒ¼
blow	ğŸƒ  ğŸŒ¬
blowfish	ğŸ¡
blu-ray, cd	ğŸ’¿
blue	ğŸ˜°  ğŸ’™  ğŸ“˜  ğŸ”·  ğŸ”¹  ğŸ”µ
blush	ğŸ˜Š
boar	ğŸ—
boat	â›µ  ğŸš£  ğŸš¤  ğŸ›¥
body	ğŸ™Œ  ğŸ™  ğŸ‘ˆ  â˜š  â˜œ  ğŸ–š  ğŸ–˜  ğŸ–œ  ğŸ‘‰  â˜›  â˜  ğŸ–  ğŸ–›  ğŸ–™  â˜  ğŸ–¢ 
ğŸ–  ğŸ–   ğŸ‘†  ğŸ–•  â˜Ÿ  ğŸ–—  ğŸ–£  ğŸ–Ÿ  ğŸ–¡  ğŸ‘‡  âœŒ  ğŸ–”  ğŸ––  âœŠ  âœ‹  ğŸ‘Š 
ğŸ‘‹  ğŸ‘Œ  ğŸ‘  ğŸ–’  ğŸ‘  ğŸ–“  ğŸ‘  ğŸ‘  âœ  ğŸ–  ğŸ–  ğŸ–  ğŸ–‘  ğŸ’…  ğŸ’ª  ğŸ‘£ 
ğŸ‘€  ğŸ‘  ğŸ‘‚  ğŸ‘ƒ  ğŸ‘…  ğŸ’€  ğŸ•±  â˜   ğŸ‘„  ğŸ—¢
bolivarian, venezuela	ğŸ‡»ğŸ‡ª
bolivia, plurinational	ğŸ‡§ğŸ‡´
bolt, nut	ğŸ”©
bomb	ğŸ’£
bonaire, caribbean, eustatius, saba	ğŸ‡§ğŸ‡¶
bone, meat	ğŸ–
book	ğŸ“”  ğŸ“•  ğŸ“–  ğŸ“—  ğŸ“˜  ğŸ“™  ğŸ“š  ğŸ•®
bookmark	ğŸ“‘  ğŸ”–
books	ğŸ“š
boom, collision	ğŸ’¥
boot	ğŸ‘¢
bosnia, herzegovina	ğŸ‡§ğŸ‡¦
botswana	ğŸ‡§ğŸ‡¼
bottle	ğŸ¶  ğŸ¼
bouquet	ğŸ’  ğŸ•
bouvet	ğŸ‡§ğŸ‡»
bowl, noodle, ramen, steaming	ğŸœ
bowling	ğŸ³
box	ğŸ±  â›  ğŸ“¤  ğŸ“¥  ğŸ“¦  ğŸ—ƒ  ğŸ—³  â˜‘  â˜’  â˜
boy	ğŸ‘¦  ğŸ›‰
branch	â¸™
brazil	ğŸ‡§ğŸ‡·
brazzaville	ğŸ‡¨ğŸ‡¬
bread, loaf	ğŸ
break, broken	ğŸ’”
bride, veil	ğŸ‘°
bridge	ğŸŒ‰
briefcase	ğŸ’¼
bright	ğŸ˜  â˜€  â˜¼  ğŸŒ  ğŸŒ  ğŸŒ£  ğŸ”†
brightness	ğŸ”…  ğŸ”†
britain, cornwall, great, kingdom, scotland, wales	ğŸ‡¬ğŸ‡§
british	ğŸ‡®ğŸ‡´  ğŸ‡»ğŸ‡¬
brunei, darussalam	ğŸ‡§ğŸ‡³
bubble	ğŸ’¬  ğŸ’­  ğŸ—¨  ğŸ—©  ğŸ—ª  ğŸ—«  ğŸ—¬  ğŸ—­  ğŸ—®  ğŸ—¯  ğŸ—°  ğŸ—±
buddhist, dharma	â˜¸
buffalo	ğŸƒ
bug	ğŸ›
building	ğŸ›  ğŸ—  ğŸ˜  ğŸ™  ğŸš  ğŸ   ğŸ¡  â›ª  ğŸ¢  ğŸ£  ğŸ¤  ğŸ¥  ğŸ¦  ğŸ¨  ğŸ©  ğŸª 
ğŸ«  ğŸ¬  ğŸ­  ğŸ¯  ğŸ°  ğŸŒ†  ğŸŒ‡
bulb, idea	ğŸ’¡
bulgaria	ğŸ‡§ğŸ‡¬
bullâ€™s eye, dart, hit, target	ğŸ¯
bullet	â˜™  â¥  â§  ğŸš…
bullhorn	ğŸ•«  ğŸ•¬
bunny	ğŸ‘¯  ğŸ°  ğŸ‡
burger, hamburger	ğŸ”
burkina, faso	ğŸ‡§ğŸ‡«
burma, myanmar	ğŸ‡²ğŸ‡²
burundi	ğŸ‡§ğŸ‡®
bus	ğŸšŒ  ğŸš  ğŸš  ğŸš  ğŸš
business	ğŸ•´
busstop	ğŸš
bust	ğŸ‘¤  ğŸ‘¥
button	ğŸ”¼  ğŸ”½  ğŸ–¯  ğŸ–°  ğŸ–±  ğŸ”˜  ğŸ”²  ğŸ”³
cabinet	ğŸ—„
cable, gondola	ğŸš   ğŸš¡
cabo, cape, verde	ğŸ‡¨ğŸ‡»
cactus	ğŸŒµ
caduceus	â˜¤
caicos, turks	ğŸ‡¹ğŸ‡¨
cake	ğŸ¥  ğŸ‚  ğŸ°
calculator, pocket	ğŸ–©
caledonia	ğŸ‡³ğŸ‡¨
calendar	ğŸ“…  ğŸ“†  ğŸ—“
call, calling, finish	ğŸ“²
cambodia	ğŸ‡°ğŸ‡­
camel, hump	ğŸª  ğŸ«
camera	ğŸ¥  ğŸ¦  ğŸ“·  ğŸ“¸  ğŸ“¹
cameroon	ğŸ‡¨ğŸ‡²
camping	ğŸ•  â›º
canada	ğŸ‡¨ğŸ‡¦
canary	ğŸ‡®ğŸ‡¨
cancel, multiplication, multiply	âœ•  âœ–  ğŸ—™  âŒ
cancer	â™‹
candle	ğŸ•¯
candy	ğŸ¬  ğŸ­
cap, graduation	ğŸ“
capricorn	â™‘
car	ğŸšƒ  ğŸš  ğŸš‹  ğŸš“  ğŸš”  ğŸš—  ğŸš˜  ğŸ  ğŸš¨  ğŸš¡  â›  â›
card	â™   â™¤  â™¥  â™¡  â™¦  â™¢  â™£  â™§  ğŸƒ  ğŸ´  ğŸ’³  ğŸ—‚  ğŸ“‡  ğŸ—ƒ
care, manicure, nail, polish	ğŸ’…
carousel	ğŸ 
carp, flags, streamer	ğŸ
castle	ğŸ¯  ğŸ°
cat	ğŸ±  ğŸ˜¸  ğŸ˜¹  ğŸ˜º  ğŸ˜»  ğŸ˜¼  ğŸ˜½  ğŸ˜¾  ğŸ˜¿  ğŸ™€  ğŸˆ
cayman	ğŸ‡°ğŸ‡¾
celebration	ğŸ…  ğŸ™Œ  ğŸ”  ğŸ•  ğŸ‚  ğŸƒ  ğŸ„  ğŸ†  ğŸ‡  ğŸˆ  ğŸ‰  ğŸŠ  ğŸ‹  ğŸŒ  ğŸ  ğŸ 
ğŸ  ğŸ  ğŸ‘  ğŸ“  ğŸ€  ğŸ  ğŸ–  ğŸ—
cell	ğŸ“±  ğŸ“³  ğŸ“´  ğŸ“²  ğŸ“µ
ceremony	ğŸ‘
ceuta, melilla	ğŸ‡ªğŸ‡¦
chad	ğŸ‡¹ğŸ‡©
chain	â›“
chair, seat	ğŸ’º
changing	ğŸš¼
channel, guernsey	ğŸ‡¬ğŸ‡¬
chapel	ğŸ’’
chart, graph	ğŸ’¹  ğŸ“ˆ  ğŸ“‰  ğŸ—   ğŸ“Š
check	âœ…  â˜‘  âœ”
check-in, departure, departures	ğŸ›«
checkered, chequered	ğŸ
cheering, mega, megaphone	ğŸ“£
cherries	ğŸ’
cherry	ğŸŒ¸  ğŸ’
chestnut	ğŸŒ°
chick	ğŸ£  ğŸ¤  ğŸ¥
chicken	ğŸ”  ğŸ—
child	ğŸ‘ª  ğŸš¸
chile	ğŸ‡¨ğŸ‡±
chime	ğŸ
china	ğŸ‡¨ğŸ‡³  ğŸ‡­ğŸ‡°  ğŸ‡²ğŸ‡´  ğŸ‡¹ğŸ‡¼
chinese	ğŸ‰‘  ğŸˆ´  ğŸˆº  ğŸˆµ  ğŸˆ¸  ğŸˆ³
chipmunk	ğŸ¿
chocolate	ğŸ«
christian	â›ª  âœ  â˜¦
christmas	ğŸ…  ğŸ„  ğŸ‡¨ğŸ‡½
church	â›ª
cinema	ğŸ¥  ğŸ¦  ğŸ“½  ğŸ
circle	â›’  â›  âº  ğŸ—Ÿ  â­•  âšª  âš«  ğŸ”´  ğŸ”µ  ğŸ”¾  ğŸ”¿  â—  ğŸ›ˆ  â“‚
circus	ğŸª
citrus, lemon	ğŸ‹
city	ğŸ™  ğŸŒ†  ğŸ‡»ğŸ‡¦
cl	ğŸ†‘
claim	ğŸ›„
clamshell	ğŸ–
clap	ğŸ‘
clapper	ğŸ¬
classical	ğŸ›
clenched, facepunch, punch	ğŸ‘Š
clipboard	ğŸ“‹
clipperton	ğŸ‡¨ğŸ‡µ
clock	âŒš  â°  â±  â²  ğŸ•°  ğŸ•›  ğŸ•§  ğŸ•  ğŸ•œ  ğŸ•‘  ğŸ•  ğŸ•’  ğŸ•  ğŸ•“  ğŸ•Ÿ  ğŸ•” 
ğŸ•   ğŸ••  ğŸ•¡  ğŸ•–  ğŸ•¢  ğŸ•—  ğŸ•£  ğŸ•˜  ğŸ•¤  ğŸ•™  ğŸ•¥  ğŸ•š  ğŸ•¦
clockwise	ğŸ”  ğŸ”‚  ğŸ”ƒ  ğŸ”„  ğŸ—˜
closed	ğŸ˜š  ğŸ“•  ğŸ“«  ğŸ“ª  ğŸ”’  ğŸ”
closet	ğŸš¾
clothes	ğŸ‘š
clothing	ğŸ‘£  ğŸ‘“  ğŸ‘”  ğŸ‘•  ğŸ‘–  ğŸ‘—  ğŸ‘˜  ğŸ‘™  ğŸ‘š  ğŸ‘›  ğŸ‘œ  ğŸ‘  ğŸ‘  ğŸ‘Ÿ  ğŸ‘   ğŸ‘¡ 
ğŸ‘¢  ğŸ‘‘  ğŸ‘’
cloud	â˜  â›…  â›ˆ  ğŸŒ¤  ğŸŒ¥  ğŸŒ¦  ğŸŒ§  ğŸŒ¨  ğŸŒ©  ğŸŒª  ğŸŒ«  ğŸŒ¬  â›†
clover	ğŸ€
clubs	â™£  â™§
clue	ğŸ—
coast, cote, cÃ´te, ivoire, ivory	ğŸ‡¨ğŸ‡®
coaster, roller	ğŸ¢
cocktail	ğŸ¸
cocos, keeling	ğŸ‡¨ğŸ‡¨
coffin	âš°
coin, purse	ğŸ‘›
cold	ğŸ˜…  ğŸ˜“  ğŸ˜°  ğŸ˜·  ğŸ’§  ğŸ”  ğŸŒ¨  â„  â˜ƒ  â›„  â›‡
colombia	ğŸ‡¨ğŸ‡´
comet	â˜„
comic	ğŸ’ª  ğŸ’§  ğŸ’¤  ğŸ’¢  ğŸ’£  ğŸ’¥  ğŸ’¦  ğŸ’¨  ğŸ’«  ğŸ’¬  ğŸ’­  ğŸ—¤  ğŸ—¥  ğŸ—¦  ğŸ—§  ğŸ’© 
ğŸ’¡  ğŸ’ 
communication	ğŸ•¨  ğŸ•©  ğŸ•ª  ğŸ•«  ğŸ•¬  ğŸ“¢  ğŸ“£  ğŸ“¯  ğŸ“±  ğŸ“³  ğŸ“´  ğŸ–  ğŸ“²  ğŸ“µ  ğŸ“  ğŸ“¶ 
ğŸ“Ÿ  ğŸ“   ğŸ“°  ğŸ–‚  ğŸ–ƒ  ğŸ–…  ğŸ–†  ğŸ“§  ğŸ“¨  ğŸ“©  ğŸ–„  ğŸ“¤  ğŸ“¥  ğŸ“¦  ğŸ“«  ğŸ“ª 
ğŸ“¬  ğŸ“­  ğŸ“®  ğŸ–‰  ğŸ–‹  ğŸ–Š  ğŸ–Œ  ğŸ–  ğŸ“  ğŸ–ˆ  ğŸ–‡  ğŸ“¡
comoros	ğŸ‡°ğŸ‡²
compression, vice	ğŸ—œ
computer	ğŸ’»  ğŸ–¥  ğŸ–¦  ğŸ–§  ğŸ–¨  ğŸ–©  ğŸ–®  âŒ¨  ğŸ–¯  ğŸ–°  ğŸ–±  ğŸ–²  ğŸ–³  ğŸ–´  ğŸ–µ  ğŸ–¶ 
ğŸ–·  ğŸ–¸  ğŸ’½  ğŸ’¾  ğŸ’¿  ğŸ“€  ğŸ—”  ğŸ—•  ğŸ—–  ğŸ——
confetti	ğŸŠ
confounded	ğŸ˜–
confused	ğŸ˜•
congo	ğŸ‡¨ğŸ‡¬  ğŸ‡¨ğŸ‡©
congratulation, congratulations	ãŠ—
construction	ğŸ‘·  ğŸ—  ğŸš§
control	ğŸ›‚  ğŸ›
controller	ğŸ®
convenience	ğŸª
cook	ğŸ‡¨ğŸ‡°
cooked	ğŸš
cookie	ğŸª
cooking	ğŸ³  ğŸ”ª
cool	ğŸ˜  ğŸ†’
cop, officer	ğŸ‘®
copyright	Â©  â„—
corn, maize, maze	ğŸŒ½
cosmetics	ğŸ’…  ğŸ’„
costa, rica	ğŸ‡¨ğŸ‡·
couch, lamp	ğŸ›‹
couple	ğŸ’‘  ğŸ‘«  ğŸ‘¬  ğŸ‘­
couplekiss	ğŸ’
cover, decorated	ğŸ“”
cow	ğŸ®  ğŸ„
cracker	ğŸ˜
crayon	ğŸ–
cream	ğŸ¦  ğŸ¨
creature	ğŸ‘¹  ğŸ‘º  ğŸ‘»  ğŸ‘½  ğŸ‘¾
credit	ğŸ’³
crescent	ğŸŒ’  ğŸŒ˜  ğŸŒ™
croatia	ğŸ‡­ğŸ‡·
crocodile	ğŸŠ
cross	â›‘  â›ª  ğŸŒ  â›¨  âœ  â˜¦
crossbones	ğŸ•±  â˜ 
crossed	ğŸ”€  ğŸŒ  âš”
crossing	ğŸš¸  â›’
crown	ğŸ‘‘
cry, sad, tear	ğŸ˜¢  ğŸ˜­  ğŸ˜¿
crystal	ğŸ”®
cuba	ğŸ‡¨ğŸ‡º
cunha, tristan	ğŸ‡¸ğŸ‡­  ğŸ‡¹ğŸ‡¦
cup	â›¾  ğŸµ  ğŸ¶
cupid	ğŸ’˜
cur, loop	â°  â¿
curl	ğŸ“ƒ
currency, exchange	ğŸ’±
curry	ğŸ›
custard, pudding	ğŸ®
customs	ğŸ›ƒ
cyclone, twister, typhoon	ğŸŒ€
cyprus	ğŸ‡¨ğŸ‡¾
czech	ğŸ‡¨ğŸ‡¿
dagger	ğŸ—¡
dancer	ğŸ’ƒ
dancers	ğŸ‘¯
danger, voltage, zap	âš¡
dango	ğŸ¡
dark	ğŸ•¶  ğŸŒ‘
dash	ğŸ’¨  ã€°
date	ğŸ“…
david, jew, jewish	âœ¡
dazed, flushed	ğŸ˜³
deadpan, neutral	ğŸ˜
deciduous, shedding	ğŸŒ³
decrease	ğŸ—›
dejected, pensive	ğŸ˜”
delicious, savouring, um, yum	ğŸ˜‹
delivery	ğŸšš
dem.	ğŸ‡¨ğŸ‡©  ğŸ‡°ğŸ‡µ
democratic	ğŸ‡¨ğŸ‡©  ğŸ‡±ğŸ‡¦  ğŸ‡°ğŸ‡µ
denmark	ğŸ‡©ğŸ‡°
department	ğŸ¬
derelict	ğŸš
descending	ğŸ
desert	ğŸœ  ğŸ
desktop	ğŸ–¥  ğŸ—”
dessert	ğŸ¡  ğŸ¦  ğŸ§  ğŸ¨  ğŸ©  ğŸª  ğŸ‚  ğŸ°  ğŸ«  ğŸ¬  ğŸ­  ğŸ®
devil, imp	ğŸ‘¿
dialog	ğŸ’¬
diamond	â™¦  â™¢  ğŸ’  ğŸ”¶  ğŸ”·  ğŸ”¸  ğŸ”¹  ğŸ’ 
diamonds	â™¦  â™¢
dice, die	ğŸ²
diego, garcia	ğŸ‡©ğŸ‡¬
diesel	ğŸ›²
digits	0  1  2  3  4  5  6  7  8  9
dim	ğŸ”…
disabled	â›
disappointed	ğŸ˜  ğŸ˜¥
disc	ğŸ–¸  ğŸ’½  ğŸ’¾  ğŸ’¿  ğŸ“€
dish	ğŸ“¡
disk	ğŸ–´  ğŸ’¾
dividers	ğŸ—‚
division	â—
dizzy	ğŸ˜µ  ğŸ’«  ğŸŒ€
djibouti	ğŸ‡©ğŸ‡¯
doctor, medicine	ğŸ’‰  â˜¤  ğŸ’Š
document	ğŸ“ƒ  ğŸ–¹  ğŸ–º  ğŸ–»  ğŸ“„  ğŸ—‹  ğŸ—
dog	ğŸ¶  ğŸ•
doll, dolls, festival	ğŸ
dollar	ğŸ’°  ğŸ’µ  ğŸ’¸  ğŸ’²
dolphin, flipper	ğŸ¬
dominica	ğŸ‡©ğŸ‡²  ğŸ‡©ğŸ‡´
dominican	ğŸ‡©ğŸ‡´
donut, doughnut	ğŸ©
door	ğŸšª
double	â©  âª  â«  â¬  â¸  â¿
dove	ğŸ•Š
down	â˜Ÿ  ğŸ–—  ğŸ–£  ğŸ–Ÿ  ğŸ–¡  ğŸ‘‡  ğŸ‘  ğŸ–“  â››  ğŸ”½  â·  â¬  ğŸ“©  ğŸ“‰  â¬‡  â¤µ 
ğŸ”»
dragon	ğŸ²  ğŸ‰
dress	ğŸ‘—
drink	â˜•  â›¾  ğŸµ  ğŸ¶  ğŸ·  ğŸ¸  ğŸ¹  ğŸº  ğŸ»  ğŸ¼  ğŸš°  ğŸš±
drive	âœ‡
dromedary	ğŸª
drop	ğŸ’§  â˜”  ğŸŒ¢
droplet	ğŸ’§
drum, oil	ğŸ›¢
dung, hankey, pile, poo, poop	ğŸ’©
dusk, sunset	ğŸŒ†  ğŸŒ‡
dutch, maarten	ğŸ‡¸ğŸ‡½
dvd	ğŸ’¿  ğŸ“€
e-mail	ğŸ“§
ear	ğŸ‘¯  ğŸ‘‚  ğŸŒ¾  ğŸŒ½
earth	ğŸŒ  ğŸŒ  ğŸŒ
east, leste, timor	ğŸ‡¹ğŸ‡±
ecuador	ğŸ‡ªğŸ‡¨
egg, frying, pan	ğŸ³
egypt	ğŸ‡ªğŸ‡¬
eighth	â™ª  â™«
eject	â
el, salvador	ğŸ‡¸ğŸ‡»
electric	ğŸšƒ  ğŸ’¡  ğŸ”¦  ğŸ”Œ  âš¡
electricity	ğŸ”Œ  âš¡
elephant	ğŸ˜
email	âœ‰  ğŸ“§  ğŸ“¨  ğŸ“©  ğŸ–„
emblem, trident	ğŸ”±
emirates	ğŸ‡¦ğŸ‡ª
emotion	ğŸ’‹  ğŸ’˜  â¤  ğŸ’“  ğŸ’”  ğŸ’•  ğŸ’–  ğŸ’—  ğŸ’™  ğŸ’š  ğŸ’›  ğŸ’œ  ğŸ’  ğŸ’  ğŸ’Ÿ  â˜™ 
â£  â¥  â¦  â§  ğŸ”  ğŸ’Œ  ğŸ’§  ğŸ’¤  ğŸ’¢  ğŸ’£  ğŸ’¥  ğŸ’¦  ğŸ’¨  ğŸ’«  ğŸ’¬  ğŸ’­ 
ğŸ•³  ğŸ—¤  ğŸ—¥  ğŸ—¦  ğŸ—§  ğŸ—¨  ğŸ—©  ğŸ—ª  ğŸ—«  ğŸ—¬  ğŸ—­  ğŸ—®  ğŸ—¯  ğŸ—°  ğŸ—±  ğŸ—² 
ğŸ’©  ğŸ•  â™¥  ğŸ’ 
empty	ğŸ—…  ğŸ—†  ğŸ—‡  ğŸ—‹  ğŸ—Œ  ğŸ—
end	ğŸ”š
engine	ğŸš’  ğŸ›±
entertainment	ğŸ©  ğŸ   ğŸ¡  ğŸ¢  ğŸª  ğŸ«  ğŸ­  ğŸ£  ğŸ¤  ğŸ§  ğŸ¥  ğŸ¦  ğŸ¬  ğŸ¨  ğŸ  ğŸŸ
entry	ğŸš«  â›”  â›œ  â›   â›¡
envelope	âœ‰  ğŸ–‚  ğŸ–ƒ  ğŸ–…  ğŸ–†  ğŸ“¨  ğŸ“©  ğŸ–„
equatorial	ğŸ‡¬ğŸ‡¶
eritrea	ğŸ‡ªğŸ‡·
eruption, volcano	ğŸŒ‹
estonia	ğŸ‡ªğŸ‡ª
ethiopia	ğŸ‡ªğŸ‡¹
euro	ğŸ’¶
europe	ğŸŒ
european	ğŸ¤  ğŸ°  ğŸ‡ªğŸ‡º
evening, landscape	ğŸŒ†
evergreen	ğŸŒ²
evil	ğŸ™ˆ  ğŸ™‰  ğŸ™Š
excited	ğŸ’–  ğŸ’—
exclamation	â£  â€¼  â‰  â•  â—  â¢
expressionless, inexpressive, unexpressive	ğŸ˜‘
extended	ğŸ–•
extraterrestrial	ğŸ‘½
eye	ğŸ˜  ğŸ˜„  ğŸ˜Š  ğŸ˜  ğŸ˜  ğŸ˜™  ğŸ˜š  ğŸ˜œ  ğŸ˜  ğŸ‘  ğŸ‘“  ğŸ•¶  ğŸ˜¸  ğŸ˜»  ğŸ˜½  ğŸ¯
eyeglasses	ğŸ‘“
eyes	ğŸ‘€
face	â˜º  â˜¹  â˜»  ğŸ™  ğŸ™‚  ğŸ˜€  ğŸ˜  ğŸ˜‚  ğŸ˜ƒ  ğŸ˜„  ğŸ˜…  ğŸ˜†  ğŸ˜‰  ğŸ˜Š  ğŸ˜‹  ğŸ˜Œ 
ğŸ˜  ğŸ˜  ğŸ˜  ğŸ˜  ğŸ˜‘  ğŸ˜’  ğŸ˜“  ğŸ˜”  ğŸ˜•  ğŸ˜–  ğŸ˜—  ğŸ˜˜  ğŸ˜™  ğŸ˜š  ğŸ˜›  ğŸ˜œ 
ğŸ˜  ğŸ˜  ğŸ˜Ÿ  ğŸ˜   ğŸ˜¡  ğŸ˜¢  ğŸ˜£  ğŸ˜¤  ğŸ˜¥  ğŸ˜¦  ğŸ˜§  ğŸ˜¨  ğŸ˜©  ğŸ˜ª  ğŸ˜«  ğŸ˜¬ 
ğŸ˜­  ğŸ˜®  ğŸ˜¯  ğŸ˜°  ğŸ˜±  ğŸ˜²  ğŸ˜³  ğŸ˜´  ğŸ˜µ  ğŸ˜¶  ğŸ˜·  ğŸ˜‡  ğŸ˜ˆ  ğŸ‘¿  ğŸ‘¼  ğŸ’† 
ğŸ™  ğŸ™…  ğŸ™†  ğŸ—£  ğŸ‘€  ğŸ’€  ğŸ•±  â˜   ğŸµ  ğŸ™ˆ  ğŸ™‰  ğŸ™Š  ğŸ¶  ğŸº  ğŸ±  ğŸ˜¸ 
ğŸ˜¹  ğŸ˜º  ğŸ˜»  ğŸ˜¼  ğŸ˜½  ğŸ˜¾  ğŸ˜¿  ğŸ™€  ğŸ¯  ğŸ´  ğŸ®  ğŸ·  ğŸ½  ğŸ­  ğŸ¹  ğŸ° 
ğŸ»  ğŸ¼  ğŸ¸  ğŸ²  ğŸ³  ğŸ‘¹  ğŸ‘º  ğŸ‘»  ğŸ‘½  ğŸ‘¾  ğŸ—¿  ğŸ­  ğŸ•›  ğŸ•§  ğŸ•  ğŸ•œ 
ğŸ•‘  ğŸ•  ğŸ•’  ğŸ•  ğŸ•“  ğŸ•Ÿ  ğŸ•”  ğŸ•   ğŸ••  ğŸ•¡  ğŸ•–  ğŸ•¢  ğŸ•—  ğŸ•£  ğŸ•˜  ğŸ•¤ 
ğŸ•™  ğŸ•¥  ğŸ•š  ğŸ•¦  ğŸŒš  ğŸŒ›  ğŸŒœ  ğŸŒ  ğŸŒ  ğŸŒ¬
factory	ğŸ­
faeroe, faroe	ğŸ‡«ğŸ‡´
fairy tale	ğŸ‘¿  ğŸ‘¸  ğŸ‘¼  ğŸ’€  ğŸ‘¹  ğŸ‘º  ğŸ‘»  ğŸ‘½  ğŸ‘¾
falkland, islas, malvinas	ğŸ‡«ğŸ‡°
fallen	ğŸ  ğŸ‚
falling	ğŸ‚  ğŸŒ 
family, mother	ğŸ‘ª
fantasy	ğŸ˜‡  ğŸ˜ˆ  ğŸ‘¿  ğŸ‘¸  ğŸ…  ğŸ‘¼  ğŸ‘¹  ğŸ‘º  ğŸ‘»  ğŸ‘½  ğŸ‘¾  ğŸš€  ğŸ”®
fast, forward	â©
father	ğŸ…  ğŸ‘ª
fax	ğŸ“   ğŸ–·
fear, fearful, scared	ğŸ˜¨  ğŸ˜±
fed., federated, micronesia	ğŸ‡«ğŸ‡²
federation, russia, russian	ğŸ‡·ğŸ‡º
feet, paw	ğŸ¾
ferris	ğŸ¡
ferry	â›´
fiji	ğŸ‡«ğŸ‡¯
file	ğŸ“  ğŸ“‚  ğŸ—ƒ  ğŸ—„
film	ğŸ¦  ğŸ“½  ğŸ
finger	ğŸ‘ˆ  â˜š  â˜œ  ğŸ–š  ğŸ–˜  ğŸ–œ  ğŸ‘‰  â˜›  â˜  ğŸ–  ğŸ–›  ğŸ–™  â˜  ğŸ–¢  ğŸ–  ğŸ–  
ğŸ‘†  ğŸ–•  â˜Ÿ  ğŸ–—  ğŸ–£  ğŸ–Ÿ  ğŸ–¡  ğŸ‘‡  ğŸ––  ğŸ–  ğŸ–‘
finland	ğŸ‡«ğŸ‡®
fire	ğŸš’  ğŸ›±  ğŸ”¥
firework	ğŸ†  ğŸ‡
fireworks	ğŸ†
fish	ğŸŸ  ğŸ   ğŸ¥  ğŸ£
fishing	ğŸ£
fist	âœŠ  ğŸ‘Š
fitz-minimal	ğŸ‘¦  ğŸ‘§  ğŸ‘¨  ğŸ‘©  ğŸ‘´  ğŸ‘µ  ğŸ‘¶  ğŸ‘±  ğŸ‘®  ğŸ‘²  ğŸ‘³  ğŸ‘·  ğŸ‘¸  ğŸ’‚  ğŸ…  ğŸ‘¼ 
ğŸ‘¯  ğŸ’†  ğŸ’‡  ğŸ‘°  ğŸ™  ğŸ™  ğŸ™…  ğŸ™†  ğŸ’  ğŸ™‹  ğŸ™‡
fitz-optional	â˜º  â˜¹  â˜»  ğŸ™  ğŸ™‚  ğŸ˜€  ğŸ˜  ğŸ˜‚  ğŸ˜ƒ  ğŸ˜„  ğŸ˜…  ğŸ˜†  ğŸ˜‰  ğŸ˜Š  ğŸ˜‹  ğŸ˜Œ 
ğŸ˜  ğŸ˜  ğŸ˜  ğŸ˜  ğŸ˜‘  ğŸ˜’  ğŸ˜“  ğŸ˜”  ğŸ˜•  ğŸ˜–  ğŸ˜—  ğŸ˜˜  ğŸ˜™  ğŸ˜š  ğŸ˜›  ğŸ˜œ 
ğŸ˜  ğŸ˜  ğŸ˜Ÿ  ğŸ˜   ğŸ˜¡  ğŸ˜¢  ğŸ˜£  ğŸ˜¤  ğŸ˜¥  ğŸ˜¦  ğŸ˜§  ğŸ˜¨  ğŸ˜©  ğŸ˜ª  ğŸ˜«  ğŸ˜¬ 
ğŸ˜­  ğŸ˜®  ğŸ˜¯  ğŸ˜°  ğŸ˜±  ğŸ˜²  ğŸ˜³  ğŸ˜´  ğŸ˜µ  ğŸ˜¶  ğŸ˜·  ğŸ˜‡  ğŸ˜ˆ  ğŸ‘¿  ğŸ™Œ  ğŸ™ 
ğŸš¶  ğŸƒ  ğŸ’ƒ  ğŸ‘ˆ  ğŸ‘‰  â˜  ğŸ–¢  ğŸ–  ğŸ–   ğŸ‘†  ğŸ–•  â˜Ÿ  ğŸ–—  ğŸ–£  ğŸ–Ÿ  ğŸ–¡ 
ğŸ‘‡  âœŒ  ğŸ–”  ğŸ––  âœŠ  âœ‹  ğŸ‘Š  ğŸ‘‹  ğŸ‘Œ  ğŸ‘  ğŸ–’  ğŸ‘  ğŸ–“  ğŸ‘  ğŸ‘  âœ 
ğŸ–  ğŸ–  ğŸ–  ğŸ–‘  ğŸ’…  ğŸ’ª  ğŸ‘€  ğŸ‘  ğŸ‘‚  ğŸ‘ƒ  ğŸ‘…  ğŸ’‹  ğŸ‘„  ğŸ—¢  ğŸš´  ğŸšµ 
ğŸš£  ğŸ›€  ğŸ‚  ğŸ„  ğŸ‡  ğŸŠ
flag	â›³  ğŸŒ  ğŸ“«  ğŸ“ª  ğŸ“¬  ğŸ“­  ğŸ  âš  âš‘  â›¿  ğŸ±  ğŸ²  ğŸ³  ğŸ´  ğŸš©  ğŸ‡¦ğŸ‡« 
ğŸ‡¦ğŸ‡½  ğŸ‡¦ğŸ‡±  ğŸ‡©ğŸ‡¿  ğŸ‡¦ğŸ‡¸  ğŸ‡¦ğŸ‡©  ğŸ‡¦ğŸ‡´  ğŸ‡¦ğŸ‡®  ğŸ‡¦ğŸ‡¶  ğŸ‡¦ğŸ‡¬  ğŸ‡¦ğŸ‡·  ğŸ‡¦ğŸ‡²  ğŸ‡¦ğŸ‡¼  ğŸ‡¦ğŸ‡¨  ğŸ‡¦ğŸ‡º  ğŸ‡¦ğŸ‡¹  ğŸ‡¦ğŸ‡¿ 
ğŸ‡§ğŸ‡¸  ğŸ‡§ğŸ‡­  ğŸ‡§ğŸ‡©  ğŸ‡§ğŸ‡§  ğŸ‡§ğŸ‡¾  ğŸ‡§ğŸ‡ª  ğŸ‡§ğŸ‡¿  ğŸ‡§ğŸ‡¯  ğŸ‡§ğŸ‡²  ğŸ‡§ğŸ‡¹  ğŸ‡§ğŸ‡´  ğŸ‡§ğŸ‡¦  ğŸ‡§ğŸ‡¼  ğŸ‡§ğŸ‡»  ğŸ‡§ğŸ‡·  ğŸ‡®ğŸ‡´ 
ğŸ‡»ğŸ‡¬  ğŸ‡§ğŸ‡³  ğŸ‡§ğŸ‡¬  ğŸ‡§ğŸ‡«  ğŸ‡§ğŸ‡®  ğŸ‡°ğŸ‡­  ğŸ‡¨ğŸ‡²  ğŸ‡¨ğŸ‡¦  ğŸ‡®ğŸ‡¨  ğŸ‡¨ğŸ‡»  ğŸ‡§ğŸ‡¶  ğŸ‡°ğŸ‡¾  ğŸ‡¨ğŸ‡«  ğŸ‡ªğŸ‡¦  ğŸ‡¹ğŸ‡©  ğŸ‡¨ğŸ‡± 
ğŸ‡¨ğŸ‡³  ğŸ‡¨ğŸ‡½  ğŸ‡¨ğŸ‡µ  ğŸ‡¨ğŸ‡¨  ğŸ‡¨ğŸ‡´  ğŸ‡°ğŸ‡²  ğŸ‡¨ğŸ‡¬  ğŸ‡¨ğŸ‡©  ğŸ‡¨ğŸ‡°  ğŸ‡¨ğŸ‡·  ğŸ‡¨ğŸ‡®  ğŸ‡­ğŸ‡·  ğŸ‡¨ğŸ‡º  ğŸ‡¨ğŸ‡¼  ğŸ‡¨ğŸ‡¾  ğŸ‡¨ğŸ‡¿ 
ğŸ‡©ğŸ‡°  ğŸ‡©ğŸ‡¬  ğŸ‡©ğŸ‡¯  ğŸ‡©ğŸ‡²  ğŸ‡©ğŸ‡´  ğŸ‡ªğŸ‡¨  ğŸ‡ªğŸ‡¬  ğŸ‡¸ğŸ‡»  ğŸ‡¬ğŸ‡¶  ğŸ‡ªğŸ‡·  ğŸ‡ªğŸ‡ª  ğŸ‡ªğŸ‡¹  ğŸ‡ªğŸ‡º  ğŸ‡«ğŸ‡°  ğŸ‡«ğŸ‡´  ğŸ‡«ğŸ‡¯ 
ğŸ‡«ğŸ‡®  ğŸ‡«ğŸ‡·  ğŸ‡¬ğŸ‡«  ğŸ‡µğŸ‡«  ğŸ‡¹ğŸ‡«  ğŸ‡¬ğŸ‡¦  ğŸ‡¬ğŸ‡²  ğŸ‡¬ğŸ‡ª  ğŸ‡©ğŸ‡ª  ğŸ‡¬ğŸ‡­  ğŸ‡¬ğŸ‡®  ğŸ‡¬ğŸ‡·  ğŸ‡¬ğŸ‡±  ğŸ‡¬ğŸ‡©  ğŸ‡¬ğŸ‡µ  ğŸ‡¬ğŸ‡º 
ğŸ‡¬ğŸ‡¹  ğŸ‡¬ğŸ‡¬  ğŸ‡¬ğŸ‡³  ğŸ‡¬ğŸ‡¼  ğŸ‡¬ğŸ‡¾  ğŸ‡­ğŸ‡¹  ğŸ‡­ğŸ‡²  ğŸ‡­ğŸ‡³  ğŸ‡­ğŸ‡°  ğŸ‡­ğŸ‡º  ğŸ‡®ğŸ‡¸  ğŸ‡®ğŸ‡³  ğŸ‡®ğŸ‡©  ğŸ‡®ğŸ‡·  ğŸ‡®ğŸ‡¶  ğŸ‡®ğŸ‡ª 
ğŸ‡®ğŸ‡²  ğŸ‡®ğŸ‡±  ğŸ‡®ğŸ‡¹  ğŸ‡¯ğŸ‡²  ğŸ‡¯ğŸ‡µ  ğŸ‡¯ğŸ‡ª  ğŸ‡¯ğŸ‡´  ğŸ‡°ğŸ‡¿  ğŸ‡°ğŸ‡ª  ğŸ‡°ğŸ‡®  ğŸ‡½ğŸ‡°  ğŸ‡°ğŸ‡¼  ğŸ‡°ğŸ‡¬  ğŸ‡±ğŸ‡¦  ğŸ‡±ğŸ‡»  ğŸ‡±ğŸ‡§ 
ğŸ‡±ğŸ‡¸  ğŸ‡±ğŸ‡·  ğŸ‡±ğŸ‡¾  ğŸ‡±ğŸ‡®  ğŸ‡±ğŸ‡¹  ğŸ‡±ğŸ‡º  ğŸ‡²ğŸ‡´  ğŸ‡²ğŸ‡°  ğŸ‡²ğŸ‡¬  ğŸ‡²ğŸ‡¼  ğŸ‡²ğŸ‡¾  ğŸ‡²ğŸ‡»  ğŸ‡²ğŸ‡±  ğŸ‡²ğŸ‡¹  ğŸ‡²ğŸ‡­  ğŸ‡²ğŸ‡¶ 
ğŸ‡²ğŸ‡·  ğŸ‡²ğŸ‡º  ğŸ‡¾ğŸ‡¹  ğŸ‡²ğŸ‡½  ğŸ‡«ğŸ‡²  ğŸ‡²ğŸ‡©  ğŸ‡²ğŸ‡¨  ğŸ‡²ğŸ‡³  ğŸ‡²ğŸ‡ª  ğŸ‡²ğŸ‡¸  ğŸ‡²ğŸ‡¦  ğŸ‡²ğŸ‡¿  ğŸ‡²ğŸ‡²  ğŸ‡³ğŸ‡¦  ğŸ‡³ğŸ‡·  ğŸ‡³ğŸ‡µ 
ğŸ‡³ğŸ‡±  ğŸ‡³ğŸ‡¨  ğŸ‡³ğŸ‡¿  ğŸ‡³ğŸ‡®  ğŸ‡³ğŸ‡ª  ğŸ‡³ğŸ‡¬  ğŸ‡³ğŸ‡º  ğŸ‡³ğŸ‡«  ğŸ‡²ğŸ‡µ  ğŸ‡°ğŸ‡µ  ğŸ‡³ğŸ‡´  ğŸ‡´ğŸ‡²  ğŸ‡µğŸ‡°  ğŸ‡µğŸ‡¼  ğŸ‡µğŸ‡¸  ğŸ‡µğŸ‡¦ 
ğŸ‡µğŸ‡¬  ğŸ‡µğŸ‡¾  ğŸ‡µğŸ‡ª  ğŸ‡µğŸ‡­  ğŸ‡µğŸ‡³  ğŸ‡µğŸ‡±  ğŸ‡µğŸ‡¹  ğŸ‡µğŸ‡·  ğŸ‡¶ğŸ‡¦  ğŸ‡·ğŸ‡ª  ğŸ‡·ğŸ‡´  ğŸ‡·ğŸ‡º  ğŸ‡·ğŸ‡¼  ğŸ‡¼ğŸ‡¸  ğŸ‡¸ğŸ‡²  ğŸ‡¸ğŸ‡¹ 
ğŸ‡¸ğŸ‡¦  ğŸ‡¸ğŸ‡³  ğŸ‡·ğŸ‡¸  ğŸ‡¸ğŸ‡¨  ğŸ‡¸ğŸ‡±  ğŸ‡¸ğŸ‡¬  ğŸ‡¸ğŸ‡½  ğŸ‡¸ğŸ‡°  ğŸ‡¸ğŸ‡®  ğŸ‡¸ğŸ‡§  ğŸ‡¸ğŸ‡´  ğŸ‡¿ğŸ‡¦  ğŸ‡¬ğŸ‡¸  ğŸ‡°ğŸ‡·  ğŸ‡¸ğŸ‡¸  ğŸ‡ªğŸ‡¸ 
ğŸ‡±ğŸ‡°  ğŸ‡§ğŸ‡±  ğŸ‡¸ğŸ‡­  ğŸ‡°ğŸ‡³  ğŸ‡±ğŸ‡¨  ğŸ‡²ğŸ‡«  ğŸ‡µğŸ‡²  ğŸ‡»ğŸ‡¨  ğŸ‡¸ğŸ‡©  ğŸ‡¸ğŸ‡·  ğŸ‡¸ğŸ‡¯  ğŸ‡¸ğŸ‡¿  ğŸ‡¸ğŸ‡ª  ğŸ‡¨ğŸ‡­  ğŸ‡¸ğŸ‡¾  ğŸ‡¹ğŸ‡¼ 
ğŸ‡¹ğŸ‡¯  ğŸ‡¹ğŸ‡¿  ğŸ‡¹ğŸ‡­  ğŸ‡¹ğŸ‡±  ğŸ‡¹ğŸ‡¬  ğŸ‡¹ğŸ‡°  ğŸ‡¹ğŸ‡´  ğŸ‡¹ğŸ‡¹  ğŸ‡¹ğŸ‡¦  ğŸ‡¹ğŸ‡³  ğŸ‡¹ğŸ‡·  ğŸ‡¹ğŸ‡²  ğŸ‡¹ğŸ‡¨  ğŸ‡¹ğŸ‡»  ğŸ‡ºğŸ‡¬  ğŸ‡ºğŸ‡¦ 
ğŸ‡¦ğŸ‡ª  ğŸ‡¬ğŸ‡§  ğŸ‡ºğŸ‡¸  ğŸ‡ºğŸ‡¾  ğŸ‡ºğŸ‡²  ğŸ‡»ğŸ‡®  ğŸ‡ºğŸ‡¿  ğŸ‡»ğŸ‡º  ğŸ‡»ğŸ‡¦  ğŸ‡»ğŸ‡ª  ğŸ‡»ğŸ‡³  ğŸ‡¼ğŸ‡«  ğŸ‡ªğŸ‡­  ğŸ‡¾ğŸ‡ª  ğŸ‡¿ğŸ‡²  ğŸ‡¿ğŸ‡¼
flame	ğŸ”¥
flash	ğŸ“¸
flashlight, torch	ğŸ”¦
flat	â™­
fleur, lis	âšœ
floppy	ğŸ’¾
flower	â˜™  â¦  â§  ğŸ’  ğŸ•  âš˜  ğŸŒ¸  ğŸ’®  ğŸŒ¹  ğŸŒº  ğŸŒ»  ğŸŒ¼  ğŸŒ·  ğŸ´
fluttering, leaves	ğŸƒ
flying	ğŸ•Š  ğŸ’¸  ğŸ–…
fog	ğŸŒ  ğŸŒ«
foggy	ğŸŒ
folder	ğŸ“  ğŸ“‚  ğŸ–¿  ğŸ—€  ğŸ—
font, size	ğŸ—š  ğŸ—›
food	ğŸ˜‹  ğŸ‡  ğŸˆ  ğŸ‰  ğŸŠ  ğŸ‹  ğŸŒ  ğŸ  ğŸ  ğŸ  ğŸ  ğŸ‘  ğŸ’  ğŸ“  ğŸ…  ğŸ† 
ğŸŒ¶  ğŸ  ğŸ–  ğŸ—  ğŸ”  ğŸŸ  ğŸ•  ğŸ²  ğŸ±  ğŸ˜  ğŸ™  ğŸš  ğŸ›  ğŸœ  ğŸ  ğŸ  
ğŸ¢  ğŸ£  ğŸ¤  ğŸ¥  ğŸ¡  ğŸ¦  ğŸ§  ğŸ¨  ğŸ©  ğŸª  ğŸ‚  ğŸ°  ğŸ«  ğŸ¬  ğŸ­  ğŸ® 
ğŸ¯  â˜•  â›¾  ğŸµ  ğŸ¶  ğŸ·  ğŸ¸  ğŸ¹  ğŸº  ğŸ»  ğŸ¼  ğŸ½  ğŸ´  ğŸ³
football	ğŸˆ  ğŸ‰
footprint, footprints	ğŸ‘£
forbidden, no, not, prohibited	ğŸ™…  ğŸ™ˆ  ğŸ™‰  ğŸ™Š  ğŸš³  ğŸš«  ğŸ›‡  ğŸš­  ğŸš¯  ğŸš±  ğŸš·  â›”  ğŸ”•  ğŸ“µ  ğŸ”
fork	ğŸ½  ğŸ´
former, fyr, macedonia	ğŸ‡²ğŸ‡°
fortune, telling	ğŸ”®  ğŸ”¯
fountain	â›²  ğŸ–‹
frame	ğŸ–¼  ğŸ–½  ğŸ–¾
frames	ğŸ
france	ğŸ‡«ğŸ‡·  ğŸ‡«ğŸ‡½
free	ğŸ†“
french	ğŸŸ  ğŸ‡¬ğŸ‡«  ğŸ‡µğŸ‡«  ğŸ‡¹ğŸ‡«  ğŸ‡²ğŸ‡«
fried, prawn, shrimp	ğŸ¤
fries	ğŸŸ
frog	ğŸ¸
frowning	â˜¹  ğŸ™  ğŸ˜¦  ğŸ™
fruit	ğŸ‡  ğŸˆ  ğŸ‰  ğŸŠ  ğŸ‹  ğŸŒ  ğŸ  ğŸ  ğŸ  ğŸ  ğŸ‘  ğŸ’  ğŸ“
fuel, fuelpump, gas, pump	â›½
fuji	ğŸ—»
full	ğŸŒ•  ğŸŒ  ğŸ’¯
funeral, urn	âš±
futuna, wallis	ğŸ‡¼ğŸ‡«
gabon	ğŸ‡¬ğŸ‡¦
gambia	ğŸ‡¬ğŸ‡²
game	ğŸ°  ğŸ²  â™   â™¤  â™¥  â™¡  â™¦  â™¢  â™£  â™§  ğŸƒ  ğŸ€„  ğŸ®  ğŸ•¹  ğŸ±  ğŸ³ 
ğŸ¯  ğŸ´
garden, home	ğŸ¡
gaza, occupied, palestine, palestinian, strip, west	ğŸ‡µğŸ‡¸
gear	âš™
gem, jewel	ğŸ’
gemini	â™Š
geometric	â–ª  â–«  â—»  â—¼  â—½  â—¾  â˜  â¬›  â¬œ  ğŸ”¶  ğŸ”·  ğŸ”¸  ğŸ”¹  ğŸ”º  ğŸ”»  ğŸ’  
ğŸ”˜  ğŸ”²  ğŸ”³  âšª  âš«  ğŸ”´  ğŸ”µ  ğŸ”¾  ğŸ”¿
georgia	ğŸ‡¬ğŸ‡ª  ğŸ‡¬ğŸ‡¸
germany	ğŸ‡©ğŸ‡ª
gesture	ğŸ™  ğŸ™  ğŸ™…  ğŸ™†  ğŸ™‹  ğŸ™‡  ğŸ™Œ  ğŸ™  ğŸ™ˆ  ğŸ™‰  ğŸ™Š
ghana	ğŸ‡¬ğŸ‡­
ghost	ğŸ‘»
gibbous	ğŸŒ”  ğŸŒ–
gibraltar	ğŸ‡¬ğŸ‡®
gift, present, wrapped	ğŸ
girl	ğŸ‘§  ğŸ‘¯  ğŸ›Š
glass	ğŸ·  ğŸ¸  ğŸ”  ğŸ”
glasses	ğŸ˜  ğŸ‘“  ğŸ•¶
glittery, glowing, shining	ğŸŒŸ
globe	ğŸŒ  ğŸŒ  ğŸŒ  ğŸŒ
goat	ğŸ
goblin	ğŸ‘º
golf, golfing	â›³
golfer	ğŸŒ
grapes	ğŸ‡
graveyard, headstone	â›¼
greece	ğŸ‡¬ğŸ‡·
green	ğŸ’š  ğŸ  ğŸ“—  ğŸ”°
greenland	ğŸ‡¬ğŸ‡±
grenada	ğŸ‡¬ğŸ‡©
grenadines, vincent	ğŸ‡»ğŸ‡¨
grimace, grimacing	ğŸ˜¬
grin, grinning	ğŸ˜€  ğŸ˜  ğŸ˜¸
growing, heartpulse, nervous	ğŸ’—
gua, mao, pi	ğŸ‘²
guadeloupe	ğŸ‡¬ğŸ‡µ
guam	ğŸ‡¬ğŸ‡º
guard, guardsman	ğŸ’‚
guatemala	ğŸ‡¬ğŸ‡¹
guiana	ğŸ‡¬ğŸ‡«
guinea	ğŸ‡¬ğŸ‡¶  ğŸ‡¬ğŸ‡³  ğŸ‡¬ğŸ‡¼  ğŸ‡µğŸ‡¬
guitar	ğŸ¸
gun, pistol, revolver	ğŸ”«
guyana	ğŸ‡¬ğŸ‡¾
haiti	ğŸ‡­ğŸ‡¹
halloween, jack	ğŸƒ
halo, innocent	ğŸ˜‡
hammer	ğŸ”¨  âš’  ğŸ› 
hamster	ğŸ¹
hand	ğŸ™‹  ğŸ™Œ  ğŸ™  ğŸ‘«  ğŸ‘¬  ğŸ‘­  ğŸ‘ˆ  â˜š  â˜œ  ğŸ–š  ğŸ–˜  ğŸ–œ  ğŸ‘‰  â˜›  â˜  ğŸ– 
ğŸ–›  ğŸ–™  â˜  ğŸ–¢  ğŸ–  ğŸ–   ğŸ‘†  ğŸ–•  â˜Ÿ  ğŸ–—  ğŸ–£  ğŸ–Ÿ  ğŸ–¡  ğŸ‘‡  âœŒ  ğŸ–” 
ğŸ––  âœŠ  âœ‹  ğŸ‘Š  ğŸ‘‹  ğŸ‘Œ  ğŸ‘  ğŸ–’  ğŸ‘  ğŸ–“  ğŸ‘  ğŸ‘  âœ  ğŸ–  ğŸ–  ğŸ– 
ğŸ–‘  ğŸ—¢  ğŸ“¢
handbag	ğŸ‘œ
happy	ğŸ™‹
hard	ğŸ–´
hash	#âƒ£
hat	ğŸ‘’  ğŸ©
hatching	ğŸ£
head, speaking	ğŸ—£
headphone, headphones	ğŸ§
hear	ğŸ™‰
heard, mcdonald	ğŸ‡­ğŸ‡²
heart	ğŸ˜  ğŸ˜˜  ğŸ’‘  ğŸ’‹  ğŸ’˜  â¤  ğŸ’“  ğŸ’”  ğŸ’•  ğŸ’–  ğŸ’—  ğŸ’™  ğŸ’š  ğŸ’›  ğŸ’œ  ğŸ’ 
ğŸ’  ğŸ’Ÿ  â˜™  â£  â¥  â¦  â§  ğŸ”  ğŸ’Œ  ğŸ˜»  â™¥  â™¡
hearts	â™¥  â™¡
heel	ğŸ‘ 
helena	ğŸ‡¸ğŸ‡­
helicopter	ğŸš
helm	âˆ
helmet	â›‘
help	ğŸ’  ğŸ†˜
herb	ğŸŒ¿
hermes	âšš
hibiscus	ğŸŒº
high	ğŸ”Š  âš¡
hiker, hiking, walk, walker, walking	ğŸš¶
hindu, om	ğŸ•‰
hocho	ğŸ”ª
hold	ğŸ‘«  ğŸ‘¬  ğŸ‘­
hole	ğŸ•³  â›³
holy, vatican	ğŸ‡»ğŸ‡¦
honduras	ğŸ‡­ğŸ‡³
honey, honeypot	ğŸ¯
hong, kong	ğŸ‡­ğŸ‡°
hooray	ğŸ™Œ
horn	ğŸ˜ˆ  ğŸ“¯
horrible, taste	ğŸ˜
horse	ğŸ´  ğŸ  ğŸ   ğŸ‡
hospital	ğŸ¥
hot	ğŸŒ¶  â˜•  â™¨
hotel	ğŸ¨  ğŸ©  ğŸ›  ğŸ›Œ  ğŸ›  ğŸ›‹  ğŸ›
hotsprings, springs	â™¨
hourglass, sand	âŒ›  â³
house	ğŸ˜  ğŸš  ğŸ   ğŸ¡
human	â˜º  â˜¹  â˜»  ğŸ™  ğŸ™‚  ğŸ˜€  ğŸ˜  ğŸ˜‚  ğŸ˜ƒ  ğŸ˜„  ğŸ˜…  ğŸ˜†  ğŸ˜‰  ğŸ˜Š  ğŸ˜‹  ğŸ˜Œ 
ğŸ˜  ğŸ˜  ğŸ˜  ğŸ˜  ğŸ˜‘  ğŸ˜’  ğŸ˜“  ğŸ˜”  ğŸ˜•  ğŸ˜–  ğŸ˜—  ğŸ˜˜  ğŸ˜™  ğŸ˜š  ğŸ˜›  ğŸ˜œ 
ğŸ˜  ğŸ˜  ğŸ˜Ÿ  ğŸ˜   ğŸ˜¡  ğŸ˜¢  ğŸ˜£  ğŸ˜¤  ğŸ˜¥  ğŸ˜¦  ğŸ˜§  ğŸ˜¨  ğŸ˜©  ğŸ˜ª  ğŸ˜«  ğŸ˜¬ 
ğŸ˜­  ğŸ˜®  ğŸ˜¯  ğŸ˜°  ğŸ˜±  ğŸ˜²  ğŸ˜³  ğŸ˜´  ğŸ˜µ  ğŸ˜¶  ğŸ˜·  ğŸ˜‡  ğŸ˜ˆ  ğŸ‘¿  ğŸ‘¦  ğŸ‘§ 
ğŸ‘¨  ğŸ‘©  ğŸ‘´  ğŸ‘µ  ğŸ‘¶  ğŸ‘±  ğŸ‘®  ğŸ‘²  ğŸ‘³  ğŸ‘·  ğŸ‘¸  ğŸ’‚  ğŸ…  ğŸ‘¼  ğŸ•µ  ğŸ‘¯ 
ğŸ’†  ğŸ’‡  ğŸ‘°  ğŸ™  ğŸ™  ğŸ™…  ğŸ™†  ğŸ’  ğŸ™‹  ğŸ™‡  ğŸ™Œ  ğŸ™  ğŸ—£  ğŸš¶  ğŸƒ  ğŸ’ƒ 
ğŸ•´  ğŸ’  ğŸ’‘  ğŸ‘ª  ğŸ‘«  ğŸ‘¬  ğŸ‘­  ğŸ‘ˆ  â˜š  â˜œ  ğŸ–š  ğŸ–˜  ğŸ–œ  ğŸ‘‰  â˜›  â˜ 
ğŸ–  ğŸ–›  ğŸ–™  â˜  ğŸ–¢  ğŸ–  ğŸ–   ğŸ‘†  ğŸ–•  â˜Ÿ  ğŸ–—  ğŸ–£  ğŸ–Ÿ  ğŸ–¡  ğŸ‘‡  âœŒ 
ğŸ–”  ğŸ––  âœŠ  âœ‹  ğŸ‘Š  ğŸ‘‹  ğŸ‘Œ  ğŸ‘  ğŸ–’  ğŸ‘  ğŸ–“  ğŸ‘  ğŸ‘  âœ  ğŸ–  ğŸ– 
ğŸ–  ğŸ–‘  ğŸ’…  ğŸ’ª  ğŸ‘€  ğŸ‘  ğŸ‘‚  ğŸ‘ƒ  ğŸ‘…  ğŸ’‹  ğŸ‘„  ğŸ—¢  ğŸš´  ğŸšµ  ğŸ  ğŸŒ 
â›·  ğŸ‚  ğŸ„  ğŸ‡  ğŸŠ  â›¹  ğŸ‹
hungary	ğŸ‡­ğŸ‡º
hushed, stunned	ğŸ˜¯
ice	ğŸ¦  ğŸ§  ğŸ¨  â›¸
icecream, soft	ğŸ¦
iceland	ğŸ‡®ğŸ‡¸
id, identity	ğŸ†”
ideograph	ãŠ—  ãŠ™
inbox	ğŸ“¥
incoming	ğŸ“¨
increase	ğŸ—š
index	ğŸ‘ˆ  â˜š  â˜œ  ğŸ–š  ğŸ–˜  ğŸ–œ  ğŸ‘‰  â˜›  â˜  ğŸ–  ğŸ–›  ğŸ–™  â˜  ğŸ–¢  ğŸ–  ğŸ–  
ğŸ‘†  â˜Ÿ  ğŸ–—  ğŸ–£  ğŸ–Ÿ  ğŸ–¡  ğŸ‘‡  ğŸ—‚  ğŸ“‡
india	ğŸ‡®ğŸ‡³
indian	ğŸ‡®ğŸ‡´
indonesia	ğŸ‡®ğŸ‡©
information	ğŸ’  â„¹  ğŸ›ˆ
ink, privacy	ğŸ”
input	ğŸ”   ğŸ”¡  ğŸ”¢  ğŸ”£  ğŸ”¤
inside	ğŸ’ 
instrument	ğŸ·  ğŸ¸  ğŸ¹  ğŸº  ğŸ»
interrobang	â‰
invalid, n/a, or, unknown	ğŸ‡¿ğŸ‡¿
iphone	ğŸ“±
iran, islamic	ğŸ‡®ğŸ‡·
iraq	ğŸ‡®ğŸ‡¶
ireland	ğŸ‡®ğŸ‡ª  ğŸ‡¬ğŸ‡§
ironic, wry	ğŸ˜¼
islam, muslim	â˜ª
island	ğŸ  ğŸ‡¦ğŸ‡¨  ğŸ‡§ğŸ‡»  ğŸ‡¨ğŸ‡½  ğŸ‡¨ğŸ‡µ  ğŸ‡­ğŸ‡²  ğŸ‡³ğŸ‡«
islands	ğŸ‡¦ğŸ‡½  ğŸ‡»ğŸ‡¬  ğŸ‡®ğŸ‡¨  ğŸ‡°ğŸ‡¾  ğŸ‡¨ğŸ‡¨  ğŸ‡¨ğŸ‡°  ğŸ‡«ğŸ‡°  ğŸ‡«ğŸ‡´  ğŸ‡¬ğŸ‡¬  ğŸ‡­ğŸ‡²  ğŸ‡²ğŸ‡­  ğŸ‡²ğŸ‡µ  ğŸ‡µğŸ‡³  ğŸ‡¸ğŸ‡§  ğŸ‡¬ğŸ‡¸  ğŸ‡¸ğŸ‡¯ 
ğŸ‡¹ğŸ‡¨  ğŸ‡ºğŸ‡²  ğŸ‡»ğŸ‡®  ğŸ‡¼ğŸ‡«
isle	ğŸ‡®ğŸ‡²
israel	ğŸ‡®ğŸ‡±
italy	ğŸ‡®ğŸ‡¹
jamaica	ğŸ‡¯ğŸ‡²
jan, mayen, svalbard	ğŸ‡¸ğŸ‡¯
japan	ğŸ—¾  ğŸ‡¯ğŸ‡µ
japanese	ğŸ‘¹  ğŸ‘º  ğŸ™  ğŸ¡  ğŸ£  ğŸ¯  ğŸ®  ğŸ‹  ğŸŒ  ğŸ  ğŸ  ğŸ´  ğŸ”°  ğŸˆ  ğŸˆ‚  ğŸˆ¹ 
ğŸ‰  ğŸˆ¯  ğŸˆ·  ğŸˆ¶  ğŸˆš  ğŸˆ²
jeans, pants, trousers	ğŸ‘–
jersey	ğŸ‡¯ğŸ‡ª
jockey	ğŸ‡
joke	ğŸ˜œ
joker	ğŸƒ
jordan	ğŸ‡¯ğŸ‡´
joy	ğŸ˜‚  ğŸ˜¹
joystick	ğŸ•¹
karaoke	ğŸ¤
kazakhstan	ğŸ‡°ğŸ‡¿
kebab, oden, seafood	ğŸ¢
kenya	ğŸ‡°ğŸ‡ª
key	ğŸ”  ğŸ”‘  ğŸ—  âš¿
keyboard	ğŸ˜  ğŸ¹  ğŸ–¦  ğŸ–®  âŒ¨
keycap	#âƒ£  *âƒ£  0âƒ£  1âƒ£  2âƒ£  3âƒ£  4âƒ£  5âƒ£  6âƒ£  7âƒ£  8âƒ£  9âƒ£  ğŸ”Ÿ
kimono	ğŸ‘˜
kinshasa	ğŸ‡¨ğŸ‡©
kiribati	ğŸ‡°ğŸ‡®
kiss	ğŸ˜—  ğŸ˜˜  ğŸ˜™  ğŸ˜š  ğŸ’  ğŸ’‹  ğŸ˜½
kissing	ğŸ˜—
kitts, nevis	ğŸ‡°ğŸ‡³
knife	ğŸ½  ğŸ´  ğŸ—¡  ğŸ”ª
knobs	ğŸ›
koala	ğŸ¨
korea	ğŸ‡°ğŸ‡µ  ğŸ‡°ğŸ‡·
kosovo	ğŸ‡½ğŸ‡°
kuwait	ğŸ‡°ğŸ‡¼
kyrgyz, kyrgyzstan	ğŸ‡°ğŸ‡¬
label	ğŸ·
lane	â›’  â›˜  â›™
lanka, sri	ğŸ‡±ğŸ‡°
lantern	ğŸ®  ğŸƒ
lao, laos	ğŸ‡±ğŸ‡¦
latin, letters	ğŸ”   ğŸ”¡  ğŸ”¤
latvia	ğŸ‡±ğŸ‡»
laughing, satisfied	ğŸ˜†
lavatory	ğŸš»  ğŸš¾
leaf	ğŸŒ¿  ğŸ€  ğŸ  ğŸ‚  ğŸƒ  ğŸ”°
lebanon	ğŸ‡±ğŸ‡§
ledger	ğŸ“’
left, reverse	â—€  â´
left luggage, locker, luggage	ğŸ›…
leg, poultry	ğŸ—
leo	â™Œ
leone, sierra	ğŸ‡¸ğŸ‡±
leopard	ğŸ†
lesotho	ğŸ‡±ğŸ‡¸
letter	ğŸ’Œ  ğŸ“§  ğŸ“¨  ğŸ“©  ğŸ–„  ğŸ“¤  ğŸ“¥
level, slider	ğŸš
liberia	ğŸ‡±ğŸ‡·
liberty	ğŸ—½
libra	â™
libya, libyan	ğŸ‡±ğŸ‡¾
liechtenstein	ğŸ‡±ğŸ‡®
lifter	ğŸ‹
light	ğŸšˆ  ğŸš¨  ğŸš¥  ğŸš¦  ğŸ’¡  ğŸ”¦
lightning	ğŸ—±  ğŸ—²  ğŸŒ©  ğŸ–„
link	ğŸ”—
links	ğŸ–‡  ğŸ”—
lips	ğŸ’‹  ğŸ‘„  ğŸ—¢
lipstick, makeup	ğŸ’„
lithuania	ğŸ‡±ğŸ‡¹
litter	ğŸš®  ğŸš¯
litterbox, put	ğŸš®
lock	ğŸ”’  ğŸ”“  ğŸ”  ğŸ”  ğŸ”‘  ğŸ—  âš¿
locomotive	ğŸš‚  ğŸ›²
lollipop	ğŸ­
lorry, semi	ğŸš›
loud	ğŸ”Š  ğŸ•¬  ğŸ“¢
love	ğŸ˜  ğŸ’•  ğŸ’Œ  ğŸ˜»  ğŸ©
low	ğŸ”‰  ğŸ”…
lowered	ğŸ“ª  ğŸ“­
lucia	ğŸ‡±ğŸ‡¨
luxembourg	ğŸ‡±ğŸ‡º
m	â“‚
mad	ğŸ˜ 
madagascar	ğŸ‡²ğŸ‡¬
magnifying, search	ğŸ”  ğŸ”
mahjong	ğŸ€„
mail	ğŸ’Œ  ğŸ“§  ğŸ“¨  ğŸ“©  ğŸ–„  ğŸ“¤  ğŸ“¥  ğŸ“«  ğŸ“ª  ğŸ“¬  ğŸ“­  ğŸ“®
mailbox, postbox	ğŸ“«  ğŸ“ª  ğŸ“¬  ğŸ“­  ğŸ“®
malawi	ğŸ‡²ğŸ‡¼
malaysia	ğŸ‡²ğŸ‡¾
maldives	ğŸ‡²ğŸ‡»
mali	ğŸ‡²ğŸ‡±
malta	ğŸ‡²ğŸ‡¹
man	ğŸ‘¨  ğŸ‘´  ğŸ‘²  ğŸ‘³  ğŸ•´  ğŸ‘«  ğŸ‘  ğŸ‡®ğŸ‡²
map	ğŸ—º  ğŸ—¾
maple	ğŸ
marathon, runner	ğŸƒ
mariana	ğŸ‡²ğŸ‡µ
marino, san	ğŸ‡¸ğŸ‡²
mark	ğŸ’‹  â£  ğŸ“‘  ğŸ”–  ğŸ”›  âœ…  âœ”  âŒ  â  ã€½  â€¼  â‰  â“  â”  â•  â— 
â¢  â„¢  ğŸ†™
marker, tabs	ğŸ“‘
market, rising	ğŸ’¹
marshall	ğŸ‡²ğŸ‡­
martin	ğŸ‡²ğŸ‡«
martinique	ğŸ‡²ğŸ‡¶
mask	ğŸ˜·  ğŸ­
massage, salon	ğŸ’†
mauritania	ğŸ‡²ğŸ‡·
mauritius	ğŸ‡²ğŸ‡º
maximize	ğŸ—–
mayotte	ğŸ‡¾ğŸ‡¹
medal	ğŸ…  ğŸ–
medical	ğŸ˜·
melon	ğŸˆ
memo	ğŸ“
men	ğŸ‘¬  ğŸš¹
menâ€™s	ğŸš¹
merge	â›˜  â›™
meridians	ğŸŒ
metro, subway	ğŸš‡
metropolitan	ğŸ‡«ğŸ‡½
mexico	ğŸ‡²ğŸ‡½
mic, microphone	ğŸ™  ğŸ¤
microscope	ğŸ”¬
military	ğŸ›¦  ğŸ–
milk	ğŸ¼
milky way	ğŸŒŒ
minibus	ğŸš
minidisc	ğŸ’½
minimize	ğŸ—•
mining	â›
minus	â–
miquelon, pierre	ğŸ‡µğŸ‡²
mobile	ğŸ“±  ğŸ“³  ğŸ“´  ğŸ–  ğŸ“²  ğŸ“µ  ğŸ“¶
mode, vibration	ğŸ“³
moldova	ğŸ‡²ğŸ‡©
monaco	ğŸ‡²ğŸ‡¨
money	ğŸ’°  ğŸ’´  ğŸ’µ  ğŸ’¶  ğŸ’·  ğŸ’¸  ğŸ’±  ğŸ’²
moneybag	ğŸ’°
mongolia	ğŸ‡²ğŸ‡³
monkey	ğŸµ  ğŸ™ˆ  ğŸ™‰  ğŸ™Š  ğŸ’
monorail	ğŸš
monster	ğŸ‘¾
montenegro	ğŸ‡²ğŸ‡ª
montserrat	ğŸ‡²ğŸ‡¸
mood	ğŸ—°  ğŸ—±  ğŸ—²
moon	ğŸŒ‘  ğŸŒ’  ğŸŒ“  ğŸŒ”  ğŸŒ•  ğŸŒ–  ğŸŒ—  ğŸŒ˜  ğŸŒ™  ğŸŒš  ğŸŒ›  ğŸŒœ  â˜½  â˜¾  ğŸŒ  ğŸ‘
morning, sunrise	ğŸŒ„  ğŸŒ…
morocco	ğŸ‡²ğŸ‡¦
motorboat	ğŸ›¥
motorcycle	ğŸ
motorway	ğŸ›£
mountain	ğŸ”  â›°  ğŸ—»  ğŸŒ„  ğŸš  ğŸšµ  ğŸš 
mouse	ğŸ­  ğŸ  ğŸ–¦  ğŸ–¯  ğŸ–°  ğŸ–±
mouth	ğŸ˜ƒ  ğŸ˜„  ğŸ˜†  ğŸ˜¦  ğŸ˜®  ğŸ˜°  ğŸ˜¶  ğŸ‘„  ğŸ˜º
movie	ğŸ¥  ğŸ¦  ğŸ¬  ğŸ“½  ğŸ
moyai	ğŸ—¿
mozambique	ğŸ‡²ğŸ‡¿
mug	ğŸº
mushroom	ğŸ„
music	ğŸ¼  â™©  â™ª  ğŸµ  ğŸœ  ğŸ  â™«  â™¬  ğŸ¶  â™­  â™®  â™¯  ğŸ˜  ğŸ™  ğŸš  ğŸ› 
ğŸ·  ğŸ¸  ğŸ¹  ğŸº  ğŸ»
mute, quiet	ğŸ”‡
nam, viet, vietnam	ğŸ‡»ğŸ‡³
namibia	ğŸ‡³ğŸ‡¦
national park, park	ğŸ
natural	â™®
nature	ğŸ—²  ğŸµ  ğŸ’  ğŸ¶  ğŸ•  ğŸ©  ğŸº  ğŸ±  ğŸ˜¸  ğŸ˜¹  ğŸ˜º  ğŸ˜»  ğŸ˜¼  ğŸ˜½  ğŸ˜¾  ğŸ˜¿ 
ğŸ™€  ğŸˆ  ğŸ¯  ğŸ…  ğŸ†  ğŸ´  ğŸ  ğŸ®  ğŸ‚  ğŸƒ  ğŸ„  ğŸ·  ğŸ–  ğŸ—  ğŸ½  ğŸ 
ğŸ‘  ğŸ  ğŸª  ğŸ«  ğŸ˜  ğŸ­  ğŸ  ğŸ€  ğŸ¹  ğŸ°  ğŸ‡  ğŸ¿  ğŸ»  ğŸ¨  ğŸ¼  ğŸ¾ 
ğŸ”  ğŸ“  ğŸ£  ğŸ¤  ğŸ¥  ğŸ¦  ğŸ§  ğŸ•Š  ğŸ¸  ğŸŠ  ğŸ  ğŸ¢  ğŸ²  ğŸ‰  ğŸ³  ğŸ‹ 
ğŸ¬  ğŸŸ  ğŸ   ğŸ¡  ğŸ™  ğŸš  ğŸŒ  ğŸ›  ğŸœ  ğŸ  ğŸ  ğŸ’©  ğŸ‘½  ğŸ‘¾  ğŸ’  ğŸ• 
ğŸŒ¸  ğŸµ  ğŸ¶  ğŸŒ¹  ğŸŒº  ğŸŒ»  ğŸŒ¼  ğŸŒ·  â¸™  â˜˜  ğŸŒ±  ğŸŒ²  ğŸŒ³  ğŸŒ´  ğŸŒµ  ğŸŒ¾ 
ğŸŒ¿  ğŸ€  ğŸ  ğŸ‚  ğŸƒ  ğŸ‡  ğŸˆ  ğŸ‰  ğŸŠ  ğŸ‹  ğŸŒ  ğŸ  ğŸ  ğŸ  ğŸ  ğŸ‘ 
ğŸ’  ğŸ“  ğŸ…  ğŸ†  ğŸŒ½  ğŸŒ¶  ğŸ„  ğŸŒ°  ğŸŒ  ğŸŒ  ğŸŒ  ğŸŒ  ğŸ”  ğŸ•  ğŸ–  ğŸœ 
ğŸ  ğŸ  ğŸŒ   âš¡  â­
nauru	ğŸ‡³ğŸ‡·
necktie	ğŸ‘”
needle, shot, syringe	ğŸ’‰
nepal	ğŸ‡³ğŸ‡µ
netherlands	ğŸ‡§ğŸ‡¶  ğŸ‡¨ğŸ‡¼  ğŸ‡³ğŸ‡±
networked	ğŸ–§
new	ğŸ‡³ğŸ‡¨  ğŸ‡³ğŸ‡¿  ğŸ‡µğŸ‡¬  ğŸ†•
news, newspaper	ğŸ“°  ğŸ—
next scene, next track	â­
ng	ğŸ†–
nib	âœ‘  âœ’
nicaragua	ğŸ‡³ğŸ‡®
niger	ğŸ‡³ğŸ‡ª
nigeria	ğŸ‡³ğŸ‡¬
night	ğŸŒƒ  ğŸŒ‰
niue	ğŸ‡³ğŸ‡º
norfolk	ğŸ‡³ğŸ‡«
north	ğŸ‡°ğŸ‡µ
northeast	ğŸ›ª  â†—
northern	ğŸ‡²ğŸ‡µ  ğŸ‡¬ğŸ‡§
northwest	â†–
norway	ğŸ‡³ğŸ‡´
nose	ğŸ‘ƒ  ğŸ½
note	â™©  â™ª  ğŸµ  ğŸœ  ğŸ  â™«  â™¬  ğŸ¶  ğŸ—…  ğŸ—†  ğŸ—‡  ğŸ—ˆ  ğŸ—‰  ğŸ—Š  ğŸ’´  ğŸ’µ 
ğŸ’¶  ğŸ’·  ğŸ’¸  ğŸ—’
notebook	ğŸ“”  ğŸ““  ğŸ“’
notes	ğŸ¶
o	â­•  ğŸ…¾
object	ğŸ’§  ğŸ’£  ğŸ’¦  ğŸ’¨  ğŸ•¶  ğŸ©  ğŸ•·  ğŸ•¸  ğŸ’©  ğŸ’  âš˜  ğŸ’®  â›¼  â›²  ğŸ«  ğŸ­ 
ğŸ°  ğŸ›  ğŸšª  ğŸ›Œ  ğŸ›  ğŸ›‹  ğŸš½  ğŸš¿  ğŸ›€  ğŸ›  ğŸ›  ğŸ•°  â˜„  ğŸ•¹  ğŸ“¯  ğŸ˜ 
ğŸ™  ğŸš  ğŸ›  ğŸ“»  ğŸ“±  ğŸ“³  ğŸ“´  ğŸ“²  ğŸ“µ  ğŸ“¶  ğŸ¥  ğŸ¦  ğŸ¬  ğŸ“½  ğŸ“º  ğŸ“· 
ğŸ“¸  ğŸ“¹  ğŸ“¼  ğŸ”  ğŸ”  ğŸ”¬  ğŸ”­  ğŸ”¥  ğŸ•¯  ğŸ’¡  ğŸ”¦  ğŸƒ  ğŸ„  ğŸ†  ğŸ‡  ğŸˆ 
ğŸ‰  ğŸŠ  ğŸ‹  ğŸ  ğŸ  ğŸ  ğŸ‘  ğŸ“  ğŸ¨  ğŸ¯  ğŸ´  ğŸ€  ğŸ  ğŸ–  ğŸ—  ğŸ 
ğŸŸ  ğŸ·  ğŸ•®  ğŸ–»  ğŸ“°  ğŸ—  ğŸ—Ÿ  ğŸ”–  ğŸ–¼  ğŸ–½  ğŸ–¾  ğŸ—   âœ€  ğŸ”’  ğŸ”“  ğŸ” 
ğŸ”  ğŸ”‘  ğŸ—  âš¿  ğŸ”¨  â›  âš’  ğŸ›   ğŸ”§  ğŸ”©  âš™  ğŸ—œ  âš—  âš–  ğŸ’‰  ğŸ—¡ 
ğŸ”ª  âš”  ğŸ”«  ğŸ›¡  â›¨  ğŸ’  ğŸ”‹  ğŸ”Œ  ğŸ”—  â›“  ğŸš¬  ğŸ’„  ğŸ’  ğŸ’  ğŸ›¢  ğŸ”® 
ğŸ”¯  ğŸ”±  ğŸ—³  â˜¤  âšš  âš•  ğŸ’Š  âš›  âšœ  âš°  âš±  ğŸ”°  â˜¸
ocean	ğŸŒŠ  ğŸ‡®ğŸ‡´
oceania	ğŸ‡¶ğŸ‡´
octopus	ğŸ™
off	ğŸ“´
office	ğŸ¢  ğŸ£  ğŸ¤  ğŸ’º  â˜  â˜  âœ†  ğŸ“Ÿ  ğŸ“   ğŸ“”  ğŸ“•  ğŸ“–  ğŸ“—  ğŸ“˜  ğŸ“™  ğŸ“š 
ğŸ““  ğŸ“’  ğŸ“ƒ  ğŸ“œ  ğŸ–¹  ğŸ–º  ğŸ–»  ğŸ“„  ğŸ—…  ğŸ—†  ğŸ—‡  ğŸ—ˆ  ğŸ—‰  ğŸ—Š  ğŸ—‹  ğŸ—Œ 
ğŸ—  ğŸ—  ğŸ—  ğŸ—  ğŸ“‘  ğŸ–¼  ğŸ–½  ğŸ–¾  ğŸ’°  ğŸ’´  ğŸ’µ  ğŸ’¶  ğŸ’·  ğŸ’¸  ğŸ’±  ğŸ’² 
ğŸ’³  ğŸ’¹  âœ‰  ğŸ–‚  ğŸ–ƒ  ğŸ–…  ğŸ–†  ğŸ“§  ğŸ“¨  ğŸ“©  ğŸ–„  ğŸ“¤  ğŸ“¥  ğŸ“¦  ğŸ“«  ğŸ“ª 
ğŸ“¬  ğŸ“­  ğŸ“®  âœ  âœ  âœ  ğŸ–‰  âœ‘  âœ’  ğŸ–‹  ğŸ–Š  ğŸ–Œ  ğŸ–  ğŸ“  ğŸ’»  ğŸ–¥ 
ğŸ–¦  ğŸ–§  ğŸ–¨  ğŸ–©  ğŸ–®  ğŸ–¯  ğŸ–°  ğŸ–±  ğŸ–²  ğŸ–³  ğŸ–´  ğŸ–µ  ğŸ–¶  ğŸ–·  ğŸ–¸  ğŸ’½ 
ğŸ’¾  ğŸ’¿  ğŸ“€  ğŸ—”  ğŸ—•  ğŸ—–  ğŸ——  ğŸ’¼  ğŸ“  ğŸ“‚  ğŸ–¿  ğŸ—€  ğŸ—  ğŸ—‚  ğŸ“…  ğŸ“† 
ğŸ—’  ğŸ—“  ğŸ“‡  ğŸ“ˆ  ğŸ“‰  ğŸ“Š  ğŸ“‹  ğŸ“Œ  ğŸ–ˆ  ğŸ“  ğŸ“  ğŸ–‡  ğŸ“  ğŸ“  ğŸ“›  âœ€ 
âœ  âœ‚  âœƒ  âœ„  âœ‡  ğŸ—ƒ  ğŸ—„  ğŸ—‘  ğŸ’¯  ğŸ“¡
ogre	ğŸ‘¹
oh	ğŸ™€
ok	ğŸ™†  ğŸ‘Œ  ğŸ–  ğŸ†—
old	ğŸ‘´  ğŸ‘µ  ğŸ—
oman	ğŸ‡´ğŸ‡²
on	ğŸ”›
once	ğŸ”‚
oncoming	ğŸš  ğŸ›±  ğŸš”  ğŸš–  ğŸš˜
open	ğŸ˜ƒ  ğŸ˜„  ğŸ˜…  ğŸ˜†  ğŸ˜¦  ğŸ˜®  ğŸ˜°  ğŸ‘  ğŸ˜º  ğŸ“–  ğŸ“¬  ğŸ“­  ğŸ“‚  ğŸ—  ğŸ”“
ophiuchus	â›
optical	ğŸ–¸  ğŸ’¿
orange	ğŸŠ  ğŸ“™  ğŸ”¶  ğŸ”¸
outbox	ğŸ“¤
outgoing	ğŸ“©
outlined	â˜º  ğŸ”³  â”  â•
outlying	ğŸ‡ºğŸ‡²  ğŸ‡¶ğŸ‡´
overlap	ğŸ——
ox	ğŸ‚
package, parcel	ğŸ“¦
pad	ğŸ—‡  ğŸ—Š  ğŸ—’  ğŸ—“
page	ğŸ“ƒ  ğŸ“„  ğŸ—†  ğŸ—‰  ğŸ—Œ  ğŸ—  ğŸ—  ğŸ—  ğŸ—Ÿ
pager	ğŸ“Ÿ
paintbrush	ğŸ–Œ
pakistan	ğŸ‡µğŸ‡°
palau	ğŸ‡µğŸ‡¼
palm	â¸™  ğŸŒ´
panama	ğŸ‡µğŸ‡¦
panda	ğŸ¼
paper	ğŸ“œ  ğŸ—†  ğŸ—‰  ğŸ—Œ  ğŸ—  ğŸ“°  ğŸ—  ğŸ—Ÿ  â™¾
paperclip	ğŸ“  ğŸ–‡
papua	ğŸ‡µğŸ‡¬
paraguay	ğŸ‡µğŸ‡¾
parking	ğŸ…¿
part	ğŸ––  ã€½
party, popper, tada	ğŸ‰
passenger	ğŸ›³
passport	ğŸ›‚
password	ğŸ”‘
pasta, spaghetti	ğŸ
patrol	ğŸš“
pause	â¯  â¸
pc	ğŸ’»
peace	ğŸ•Š  â˜®
peach	ğŸ‘
pear	ğŸ
pedestrian	ğŸš¶  ğŸš·
pen	ğŸ–†  ğŸ–‹  ğŸ–Š  ğŸ”
pencil	âœ  âœ  âœ  ğŸ–‰  ğŸ“
penguin	ğŸ§
pennant	ğŸ±  ğŸ²
pepper	ğŸŒ¶
performing	ğŸ­
permanent	â™¾
perserve, persevere, persevering	ğŸ˜£
person	ğŸ‘¦  ğŸ‘§  ğŸ‘¨  ğŸ‘©  ğŸ‘´  ğŸ‘µ  ğŸ‘¶  ğŸ‘±  ğŸ‘®  ğŸ‘²  ğŸ‘³  ğŸ‘·  ğŸ‘¸  ğŸ’‚  ğŸ…  ğŸ•µ 
ğŸ‘¯  ğŸ’†  ğŸ’‡  ğŸ‘°  ğŸ™  ğŸ™  ğŸ™…  ğŸ™†  ğŸ’  ğŸ™‹  ğŸ™‡  ğŸ™Œ  ğŸ™  ğŸ—£  ğŸ‘¤  ğŸ‘¥ 
ğŸ›‰  ğŸ›Š  ğŸš¶  ğŸƒ  ğŸ’ƒ  ğŸ•´  ğŸ’  ğŸ’‘  ğŸ‘ª  ğŸ‘«  ğŸ‘¬  ğŸ‘­  ğŸš´  ğŸšµ  ğŸ  ğŸŒ 
â›·  ğŸ‚  ğŸ„  ğŸ‡  ğŸŠ  â›¹  ğŸ‹
personal	ğŸ’»  ğŸ–³
peru	ğŸ‡µğŸ‡ª
philippines	ğŸ‡µğŸ‡­
phone	ğŸ“±  ğŸ“³  ğŸ“´  ğŸ–  ğŸ“²  ğŸ“µ  â˜  ğŸ“  ğŸ“¶
piano	ğŸ¹
pick	â›  âš’
picture	ğŸ–º  ğŸ–»  ğŸ–¼
pig	ğŸ·  ğŸ–  ğŸ½
pill	ğŸ’Š
pin	ğŸ“Œ  ğŸ“
pineapple	ğŸ
pisces	â™“
pitcairn	ğŸ‡µğŸ‡³
pizza, slice	ğŸ•
place	ğŸŒ  ğŸŒ  ğŸŒ  ğŸŒ  ğŸ—º  ğŸ”  â›°  ğŸŒ‹  ğŸ—»  ğŸ•  ğŸ–  ğŸœ  ğŸ  ğŸ  ğŸŸ  ğŸ› 
ğŸ—  ğŸ˜  ğŸ™  ğŸš  ğŸ   ğŸ¡  â›ª  ğŸ¢  ğŸ£  ğŸ¤  ğŸ¥  ğŸ¦  ğŸ¨  ğŸ©  ğŸª  ğŸ« 
ğŸ¬  ğŸ­  ğŸ¯  ğŸ°  ğŸ’’  ğŸ—¼  ğŸ—½  ğŸ—¾  â›²  â›º  ğŸŒ  ğŸŒƒ  ğŸŒ„  ğŸŒ…  ğŸŒ†  ğŸŒ‡ 
ğŸŒ‰  ğŸŒŠ  ğŸŒŒ  ğŸ   ğŸ¡  ğŸ¢  ğŸ’ˆ  ğŸª  ğŸ«  ğŸ­  ğŸ°  ğŸ›°  ğŸ§  ğŸš®  ğŸŒ‘  ğŸŒ’ 
ğŸŒ“  ğŸŒ”  ğŸŒ•  ğŸŒ–  ğŸŒ—  ğŸŒ˜  ğŸŒ™  ğŸŒš  ğŸŒ›  ğŸŒœ  â˜½  â˜¾  ğŸŒ  ğŸŒ  ğŸŒŸ  ğŸŒ  
ğŸ®  ğŸ“  ğŸ”°  ğŸ›ˆ
plant	ğŸ•  ğŸŒ¸  ğŸŒ¹  ğŸŒº  ğŸŒ»  ğŸŒ¼  ğŸŒ·  â¸™  â˜˜  ğŸŒ±  ğŸŒ²  ğŸŒ³  ğŸŒ´  ğŸŒµ  ğŸŒ¾  ğŸŒ¿ 
ğŸ€  ğŸ  ğŸ‚  ğŸƒ  ğŸ‡  ğŸˆ  ğŸ‰  ğŸŠ  ğŸ‹  ğŸŒ  ğŸ  ğŸ  ğŸ  ğŸ  ğŸ‘  ğŸ’ 
ğŸ“  ğŸ…  ğŸ†  ğŸŒ½  ğŸŒ¶  ğŸ„  ğŸŒ°  ğŸ
plate	ğŸ½
play, right	â–¶  âµ  â¯
playing	ğŸƒ  ğŸ´
plug	ğŸ”Œ
plus	â•
point	ğŸ‘ˆ  â˜š  â˜œ  ğŸ–š  ğŸ–˜  ğŸ–œ  ğŸ‘‰  â˜›  â˜  ğŸ–  ğŸ–›  ğŸ–™  â˜  ğŸ–¢  ğŸ–  ğŸ–  
ğŸ‘†  â˜Ÿ  ğŸ–—  ğŸ–£  ğŸ–Ÿ  ğŸ–¡  ğŸ‘‡
poland	ğŸ‡µğŸ‡±
pole	ğŸ’ˆ  ğŸ£
police	ğŸ‘®  ğŸš“  ğŸš”  ğŸš¨
polynesia	ğŸ‡µğŸ‡«
poodle	ğŸ©
portable, stereo	ğŸ“¾
portugal	ğŸ‡µğŸ‡¹
post	ğŸ£  ğŸ¤  ğŸš©
postal	ğŸ“¯
pot	ğŸ²  ğŸ¯
potable	ğŸš°  ğŸš±
potato, roasted	ğŸ 
pouch	ğŸ‘
pound	#âƒ£  ğŸ’·
pouting	ğŸ˜¡  ğŸ™  ğŸ˜¾
previous scene, previous track	â®
princess	ğŸ‘¸
principe, prÃ­ncipe, sao, sÃ£o, tome, tomÃ©	ğŸ‡¸ğŸ‡¹
print	ğŸ‘£  ğŸ¾
printer	ğŸ–¨  ğŸ–¶
prize, trophy	ğŸ†
projector	ğŸ“½
province, taiwan	ğŸ‡¹ğŸ‡¼
puerto, rico	ğŸ‡µğŸ‡·
punctuation	â€¼  â‰  â“  â”  â•  â—  â¢  ã€°
purple	ğŸ’œ
pushpin	ğŸ“Œ  ğŸ–ˆ  ğŸ“
qatar	ğŸ‡¶ğŸ‡¦
quarter	ğŸŒ“  ğŸŒ—  ğŸŒ›  ğŸŒœ  â˜½  â˜¾  â™©
question	â‰  â“  â”
rabbit	ğŸ°  ğŸ‡
racehorse	ğŸ
racing	ğŸ  ğŸ  ğŸ‡
racquet, tennis	ğŸ¾
radio	ğŸ“»  ğŸ”˜
radioactive	â˜¢
rage	ğŸ˜¡
railway	ğŸš‚  ğŸšƒ  ğŸš„  ğŸš…  ğŸš†  ğŸ›²  ğŸšˆ  ğŸš‰  ğŸš  ğŸ›¤  ğŸšŸ
rain	â›ˆ  ğŸŒ¦  ğŸŒ§  â›†  ğŸŒˆ  ğŸŒ‚  â˜‚  â˜”  â›±
rainbow	ğŸŒˆ
raise	ğŸ™‹  ğŸ™Œ
ram	ğŸ
rat	ğŸ€
rating	ğŸ—£  ğŸ—¢  ğŸ—¡
rays	ğŸ—¤  ğŸ—¥  ğŸ—¦  ğŸ—§  â˜€  â˜¼
receive	ğŸ“²  ğŸ“¨  ğŸ“¥
receiver	ğŸ“
record	âº
recording	â„—
recreational, rv	ğŸš™
recycle, recycling, universal	â™²  â™»
red	ğŸ˜¡  ğŸ  ğŸ€„  ğŸ”¼  ğŸ”½  ğŸ®  ğŸ”º  ğŸ”»  ğŸ”´
region	ğŸ‡²ğŸ‡´  ğŸ‡¿ğŸ‡¿
registered	Â®
relaxed	â˜º
relieved	ğŸ˜Œ  ğŸ˜¥
religion	â›ª  ğŸ•‰  âœ¡  â˜¸  â˜¯  âœ  â˜¦  â›©  â˜ª
reload	ğŸ”ƒ
reminder	ğŸ—
rep.	ğŸ‡¨ğŸ‡¬  ğŸ‡¨ğŸ‡©  ğŸ‡ªğŸ‡¬  ğŸ‡®ğŸ‡·  ğŸ‡²ğŸ‡°  ğŸ‡°ğŸ‡µ  ğŸ‡°ğŸ‡·  ğŸ‡¾ğŸ‡ª
repeat	ğŸ”
republic	ğŸ‡¨ğŸ‡«  ğŸ‡¨ğŸ‡¬  ğŸ‡¨ğŸ‡©  ğŸ‡¨ğŸ‡¿  ğŸ‡©ğŸ‡´  ğŸ‡®ğŸ‡·  ğŸ‡°ğŸ‡¬  ğŸ‡±ğŸ‡¦  ğŸ‡²ğŸ‡°  ğŸ‡²ğŸ‡©  ğŸ‡°ğŸ‡µ  ğŸ‡·ğŸ‡¼  ğŸ‡¸ğŸ‡°  ğŸ‡°ğŸ‡·  ğŸ‡¸ğŸ‡¾  ğŸ‡¹ğŸ‡¿ 
ğŸ‡»ğŸ‡ª
resort, sailboat, sea, yacht	â›µ
restaurant	ğŸ  ğŸ–  ğŸ—  ğŸ”  ğŸŸ  ğŸ•  ğŸ²  ğŸ±  ğŸ˜  ğŸ™  ğŸš  ğŸ›  ğŸœ  ğŸ  ğŸ   ğŸ¢ 
ğŸ£  ğŸ¤  ğŸ¥  ğŸ¡  ğŸ¦  ğŸ§  ğŸ¨  ğŸ©  ğŸª  ğŸ°  ğŸ«  ğŸ¬  ğŸ­  ğŸ®  ğŸ¯  ğŸ¶ 
ğŸ·  ğŸ¸  ğŸ¹  ğŸº  ğŸ»  ğŸ½  ğŸ´  ğŸ³  ğŸ®
restricted	â›   â›¡
restroom	ğŸš¹  ğŸšº  ğŸš»  ğŸš¾
reunion, rÃ©union	ğŸ‡·ğŸ‡ª
revolving	ğŸ’  ğŸš¨
rewind	âª
ribbon	ğŸ’  ğŸ€  ğŸ—
rice	ğŸŒ¾  ğŸ˜  ğŸ™  ğŸš  ğŸ›
ring	ğŸ•­  ğŸ’
rocket	ğŸš€
rolled	ğŸ—
rolodex	ğŸ“‡
romance	ğŸ’  ğŸ’‘  ğŸ’‹  ğŸ’Œ  ğŸ’  ğŸ’’  ğŸ’  ğŸ’
romania	ğŸ‡·ğŸ‡´
rooster	ğŸ“
rose	ğŸŒ¹
rosette	ğŸµ  ğŸ¶
rowboat	ğŸš£
rugby	ğŸ‰
ruler	ğŸ“  ğŸ“
running	ğŸƒ  ğŸ’¨  ğŸ½
rushed	ğŸ˜°
rwanda	ğŸ‡·ğŸ‡¼
sagittarius	â™
sahara, western	ğŸ‡ªğŸ‡­
saint, st.	ğŸ‡§ğŸ‡±  ğŸ‡¸ğŸ‡­  ğŸ‡°ğŸ‡³  ğŸ‡±ğŸ‡¨  ğŸ‡²ğŸ‡«  ğŸ‡µğŸ‡²  ğŸ‡»ğŸ‡¨
sake	ğŸ¶
samoa	ğŸ‡¦ğŸ‡¸  ğŸ‡¼ğŸ‡¸
sandal	ğŸ‘¡
sandwich	ğŸ‡¬ğŸ‡¸
santa	ğŸ…
sash	ğŸ½
satchel	ğŸ’
satellite	ğŸ›°  ğŸ“¡
sax, saxophone	ğŸ·
school	ğŸ«  ğŸ’
scissors	âœ€  âœ  âœ‚  âœƒ  âœ„
score	ğŸ¼  ğŸ’¯
scorpion, scorpius	â™
scream, screaming	ğŸ˜±
screen	ğŸ–µ
scroll	ğŸ“œ
secret	ãŠ™
secure	ğŸ”
see	ğŸ™ˆ  ğŸ‡»ğŸ‡¦
seedling, young	ğŸŒ±
senegal	ğŸ‡¸ğŸ‡³
sent	ğŸ“©  ğŸ“¤
serbia	ğŸ‡·ğŸ‡¸
set	ğŸ“
seychelles	ğŸ‡¸ğŸ‡¨
shamrock	â˜˜
sharp	â™¯
shaved	ğŸ§
sheep	ğŸ  ğŸ‘
shell	ğŸš
shield	ğŸ›¡  â›¨
shinkansen, speed	ğŸš„  ğŸš…
shinto, shrine	â›©
ship	ğŸ›³  ğŸš¢
shirt	ğŸ‘•  ğŸ½
shoe	ğŸ‘  ğŸ‘Ÿ  ğŸ‘ 
shooting	ğŸŒ 
shop	ğŸ’ˆ
shopping	ğŸ›
shortcake, sliced	ğŸ°
shower	ğŸš¿
sign	ğŸ”…  ğŸ”†  âœ¨  âŒ¨  â˜¯  â˜®  â˜¢  â˜£  â™¾  â™²  âœ…  â˜‘  âœ”  âœ•  âœ–  âœ— 
âœ˜  ğŸ—™  âŒ  â  â˜’  â•  â–  â—  â°  â¿  ã€½  âœ³  âœ´  â‡  â–ª  â–« 
â—»  â—¼  â—½  â—¾  â˜  â¬›  â¬œ  ğŸ”¶  ğŸ”·  ğŸ”¸  ğŸ”¹  ğŸ”º  ğŸ”»  ğŸ’   ğŸ”˜  ğŸ”² 
ğŸ”³  âšª  âš«  ğŸ”´  ğŸ”µ  ğŸ”¾  ğŸ”¿
signal	ğŸš¥  ğŸš¦  ğŸ“¶
silent	ğŸ˜¶
silhouette	ğŸ—£  ğŸ‘¤  ğŸ‘¥
singapore	ğŸ‡¸ğŸ‡¬
sint	ğŸ‡§ğŸ‡¶  ğŸ‡¸ğŸ‡½
sixteenth	â™¬
skate, skating	â›¸
skewer, stick	ğŸ¢  ğŸ¡
ski, skier, skiing	ğŸ¿  â›·  ğŸ‚
skull	ğŸ’€  ğŸ•±  â˜ 
sleeping	ğŸ˜´  ğŸ’¤  ğŸ›Œ
sleepy	ğŸ˜ª  ğŸ’¤
sleuth, spy	ğŸ•µ
sliding	â›
slot	ğŸ°
slovak, slovakia	ğŸ‡¸ğŸ‡°
slovenia	ğŸ‡¸ğŸ‡®
smile, smiley, smiling	â˜º  â˜»  ğŸ™‚  ğŸ˜  ğŸ˜ƒ  ğŸ˜„  ğŸ˜…  ğŸ˜†  ğŸ˜Š  ğŸ˜‹  ğŸ˜  ğŸ˜  ğŸ˜™  ğŸ˜‡  ğŸ˜ˆ  ğŸ˜¸ 
ğŸ˜º  ğŸ˜»  ğŸ˜¼
smirk, smirking	ğŸ˜
smoking	ğŸš­  ğŸš¬
snail	ğŸŒ
snake	ğŸ
snow	ğŸ”  ğŸŒ¨  â„  â˜ƒ  â›„  â›‡
snowboard, snowboarder, snowboarding	ğŸ‚
snowflake	â„
snowman	â˜ƒ  â›„  â›‡
sob	ğŸ˜­
soccer	âš½
solid	â™»  â“
solomon	ğŸ‡¸ğŸ‡§
somalia	ğŸ‡¸ğŸ‡´
soon	ğŸ”œ
sos	ğŸ†˜
sound	ğŸ”‡  ğŸ”ˆ  ğŸ”‰  ğŸ”Š  ğŸ•¨  ğŸ•©  ğŸ•ª  ğŸ•«  ğŸ•¬  ğŸ“¢  ğŸ“£  ğŸ“¯  ğŸ””  ğŸ”•  ğŸ•­  â–¶ 
âµ  â©  â­  â¯  â—€  â´  âª  â®  â¶  â«  â·  â¬  â¸  â¹  âº  â 
ğŸ¼  â™©  â™ª  ğŸµ  ğŸœ  ğŸ  â™«  â™¬  ğŸ¶  â™­  â™®  â™¯  ğŸ˜  ğŸ™  ğŸš  ğŸ› 
ğŸ¤  ğŸ§  ğŸ·  ğŸ¸  ğŸ¹  ğŸº  ğŸ»  ğŸ“¾  ğŸ–  â˜  ğŸ“  â˜  ã€°  â„—
south	ğŸ‡¿ğŸ‡¦  ğŸ‡¬ğŸ‡¸  ğŸ‡°ğŸ‡·  ğŸ‡¸ğŸ‡¸
southeast	â†˜
southern	ğŸ‡¹ğŸ‡«
southwest	â†™
spade	â™   â™¤
spades	â™ 
spain	ğŸ‡ªğŸ‡¸
sparkle, sparkler	ğŸ’–  ğŸŒŸ  ğŸ‡  âœ¨  â‡
sparkles	âœ¨
speak	ğŸ™Š
speaker	ğŸ”‡  ğŸ”ˆ  ğŸ”‰  ğŸ”Š  ğŸ•¨  ğŸ•©  ğŸ•ª
speech	ğŸ’¬  ğŸ—¨  ğŸ—©  ğŸ—ª  ğŸ—«
speedboat	ğŸš¤
spider	ğŸ•·  ğŸ•¸
spiral	ğŸš  ğŸ—’  ğŸ—“
splashing	ğŸ’¦
splayed	ğŸ–  ğŸ–‘
spock, vulcan	ğŸ––
sport	ğŸƒ  ğŸš²  ğŸš³  ğŸš´  ğŸšµ  ğŸ  ğŸ  âš½  âš¾  ğŸ€  ğŸˆ  ğŸ‰  ğŸ¾  ğŸ±  ğŸ³  â›³ 
ğŸŒ  â›¸  ğŸ£  ğŸ½  ğŸ¿  â›·  ğŸ‚  ğŸ„  ğŸ‡  ğŸŠ  â›¹  ğŸ‹  ğŸ…  ğŸ†  ğŸ
spouting	ğŸ³
square	â›¾  â›  â¹  â  â–ª  â–«  â—»  â—¼  â—½  â—¾  â—ª  â¬›  â¬œ  ğŸ”²  ğŸ”³
stadium	ğŸŸ
staff	âšš  âš•
stamped	ğŸ–ƒ  ğŸ–†
star	ğŸ’«  ğŸŒƒ  ğŸŒŸ  ğŸŒ   *âƒ£  âœ¨  ğŸ”¯  âœ¡  â­  âœ´
stars	ğŸŒƒ
station	ğŸš‰  â›½
statue	ğŸ—½  ğŸ—¿
steam	ğŸš‚
stew	ğŸ²
stock	ğŸ— 
stop	ğŸš  â¹
stopwatch	â±
store	ğŸª  ğŸ¬
straight edge	ğŸ“
stuck-out	ğŸ˜›  ğŸ˜œ  ğŸ˜
studio	ğŸ™
sudan	ğŸ‡¸ğŸ‡¸  ğŸ‡¸ğŸ‡©
suit	ğŸ•´  â™   â™¤  â™¥  â™¡  â™¦  â™¢  â™£  â™§
sun	ğŸ˜  ğŸŒ»  ğŸŒ„  ğŸŒ…  â˜€  â˜¼  ğŸŒ  â›…  ğŸŒ£  ğŸŒ¤  ğŸŒ¥  ğŸŒ¦  â›±
sunflower	ğŸŒ»
sunglasses	ğŸ˜  ğŸ•¶
sunny	â˜€
surfer, surfing	ğŸ„
suriname	ğŸ‡¸ğŸ‡·
surprised	ğŸ˜¯  ğŸ™€
sushi	ğŸ£
suspension	ğŸšŸ
swaziland	ğŸ‡¸ğŸ‡¿
sweat	ğŸ˜…  ğŸ˜“  ğŸ˜°  ğŸ’§  ğŸ’¦
sweden	ğŸ‡¸ğŸ‡ª
sweet	ğŸ   ğŸ¡  ğŸ¦  ğŸ§  ğŸ¨  ğŸ©  ğŸª  ğŸ‚  ğŸ°  ğŸ«  ğŸ¬  ğŸ­  ğŸ®  ğŸ¯
swim, swimmer, swimming	ğŸŠ
swirl	ğŸ¥
switzerland	ğŸ‡¨ğŸ‡­
swords	âš”
symbols	ğŸ”£
sympathy	ğŸ˜®
syria, syrian	ğŸ‡¸ğŸ‡¾
tajikistan	ğŸ‡¹ğŸ‡¯
tangerine	ğŸŠ
tanzania	ğŸ‡¹ğŸ‡¿
tao, taoist, yang, yin	â˜¯
tape	ğŸ“¼  âœ‡
taurus	â™‰
taxi	ğŸš•  ğŸš–
tea	â˜•  ğŸµ
teacup	ğŸµ
tears	ğŸ˜‚  ğŸ˜­  ğŸ˜¹
telephone	â˜  ğŸ“  â˜  âœ†
telescope	ğŸ”­
television, tv	ğŸ“º
tent	â›º  ğŸª
territories	ğŸ‡¹ğŸ‡«  ğŸ‡µğŸ‡¸
territory	ğŸ‡®ğŸ‡´  ğŸ‡µğŸ‡¸
text	ğŸ–¹  ğŸ–º  ğŸ—Ÿ
thailand	ğŸ‡¹ğŸ‡­
thermometer	ğŸŒ¡
thought	ğŸ’­  ğŸ—¬  ğŸ—­
thumb	ğŸ‘  ğŸ–’  ğŸ‘  ğŸ–“
thunder	â›ˆ
tiger	ğŸ¯  ğŸ…
tiled	ğŸ–½
time	âŒ›  â³  âŒš  â°  â±  â²  ğŸ•›  ğŸ•§  ğŸ•  ğŸ•œ  ğŸ•‘  ğŸ•  ğŸ•’  ğŸ•  ğŸ•“  ğŸ•Ÿ 
ğŸ•”  ğŸ•   ğŸ••  ğŸ•¡  ğŸ•–  ğŸ•¢  ğŸ•—  ğŸ•£  ğŸ•˜  ğŸ•¤  ğŸ•™  ğŸ•¥  ğŸ•š  ğŸ•¦  â™ˆ  â™‰ 
â™Š  â™‹  â™Œ  â™  â™  â™  â™  â™‘  â™’  â™“  ğŸŒ‘  ğŸŒ’  ğŸŒ“  ğŸŒ”  ğŸŒ•  ğŸŒ– 
ğŸŒ—  ğŸŒ˜  ğŸŒ™  ğŸŒš
timer	âŒ›  â³  â²
tired	ğŸ˜©  ğŸ˜«
tm, trademark	â„¢
tobago, trinidad	ğŸ‡¹ğŸ‡¹
togo	ğŸ‡¹ğŸ‡¬
toilet	ğŸš½
tokelau	ğŸ‡¹ğŸ‡°
tokyo, tower	ğŸ—¼
tomato	ğŸ…
tonga	ğŸ‡¹ğŸ‡´
tongue	ğŸ˜›  ğŸ˜œ  ğŸ˜  ğŸ‘…
tool	ğŸ”¬  ğŸ”­  ğŸ”¥  ğŸ”¦  âœ€  âœ  âœ‚  âœƒ  âœ„  ğŸ”¨  â›  âš’  ğŸ›   ğŸ”§  ğŸ”©  âš™ 
ğŸ—œ  âš—  âš–  ğŸ’‰  ğŸ”ª  ğŸ”«  ğŸ”®  ğŸ”±  ğŸ”°
top	ğŸ©  ğŸ”
tophat	ğŸ©
tornado	ğŸŒª
track	ğŸ›¤
trackball	ğŸ–²
tractor	ğŸšœ
traffic	ğŸš¥  ğŸš¦  â›•  â›–  â›—
train	ğŸš‚  ğŸšƒ  ğŸš„  ğŸš…  ğŸš†  ğŸ›²  ğŸš‰
tram, trolleybus	ğŸšƒ  ğŸšŠ  ğŸš‹  ğŸš
travel	ğŸš¶  â›‘  â›¾  â›¼  â™¨  ğŸ—¿  ğŸš‚  ğŸšƒ  ğŸš„  ğŸš…  ğŸš†  ğŸ›²  ğŸš‡  ğŸšˆ  ğŸš‰  ğŸšŠ 
ğŸš  ğŸš  ğŸš‹  ğŸšŒ  ğŸš  ğŸš  ğŸš  ğŸš  ğŸš‘  ğŸš’  ğŸ›±  ğŸš“  ğŸš”  ğŸš•  ğŸš–  ğŸš— 
ğŸš˜  ğŸš™  ğŸšš  ğŸš›  ğŸšœ  ğŸš²  ğŸš³  ğŸš´  ğŸšµ  ğŸ  ğŸ  â›½  ğŸ›£  ğŸ›¤  â›Ÿ  ğŸš¨ 
âˆ  âš“  â›µ  ğŸš£  ğŸš¤  ğŸ›³  â›´  ğŸ›¥  ğŸš¢  âœˆ  ğŸ›¦  ğŸ›§  ğŸ›¨  ğŸ›©  ğŸ›ª  ğŸ›« 
ğŸ›¬  ğŸ’º  ğŸš  ğŸšŸ  ğŸš   ğŸš¡  ğŸš€  ğŸš®  ğŸš¥  ğŸš¦  ğŸš§  ğŸš«  ğŸ›‡  ğŸš­  ğŸš¯  ğŸš° 
ğŸš±  ğŸš·  ğŸš¸  â™¿  ğŸš¹  ğŸšº  ğŸš»  ğŸš¼  ğŸš¾  ğŸ†  ğŸ›‚  ğŸ›ƒ  ğŸ›„  ğŸ›…  ğŸ›†  âš  
â›  â›  â›’  â›”  â›•  â›–  â›—  â›˜  â›™  â››  â›œ  â›  â›  â›   â›¡  ğŸšª 
ğŸš½  ğŸš¿  ğŸ›€  ğŸ›  â›±  â›³  â›¸  â›·  ğŸ‡  ğŸŠ  â›¹  â›  â›¨  â›“  ğŸš¬  â›¿ 
ğŸš©  â™»  âš¡  â­•
tray	ğŸ“¤  ğŸ“¥
tree	ğŸŒ²  ğŸŒ³  ğŸŒ´  ğŸ„  ğŸ‹
trend	ğŸ’¹  ğŸ“ˆ  ğŸ“‰
triangle	ğŸ›†  â–¶  âµ  â­  â¯  â—€  â´  â®  â¶  ğŸ“
triumph, won	ğŸ˜¤
trolley	ğŸš
tropical	ğŸ   ğŸ¹
truck	ğŸš’  ğŸšš  ğŸš›  â›Ÿ
trumpet	ğŸº
tshirt	ğŸ‘•
tulip	ğŸŒ·
tunisia	ğŸ‡¹ğŸ‡³
turban	ğŸ‘³
turkey	ğŸ‡¹ğŸ‡·
turkmenistan	ğŸ‡¹ğŸ‡²
turtle	ğŸ¢
tuvalu	ğŸ‡¹ğŸ‡»
u.k., uk	ğŸ‡ºğŸ‡°
u.s.	ğŸ‡ºğŸ‡¸  ğŸ‡ºğŸ‡²  ğŸ‡»ğŸ‡®
uganda	ğŸ‡ºğŸ‡¬
ukraine	ğŸ‡ºğŸ‡¦
umbrella	ğŸ–  ğŸŒ‚  â˜‚  â˜”  â›±
unamused, unhappy	ğŸ˜’
under	ğŸ˜·  ğŸš§  ğŸ”
union	ğŸ‡ªğŸ‡º
united	ğŸ‡¹ğŸ‡¿  ğŸ‡¦ğŸ‡ª  ğŸ‡¬ğŸ‡§  ğŸ‡ºğŸ‡¸  ğŸ‡ºğŸ‡²  ğŸ‡»ğŸ‡®
unlock	ğŸ”“
up	â˜  ğŸ–¢  ğŸ–  ğŸ–   ğŸ‘†  ğŸ‘  ğŸ–’  â¶  ğŸ”  ğŸ†™
uppercase	ğŸ” 
upward	ğŸ’¹  ğŸ“ˆ
uruguay	ğŸ‡ºğŸ‡¾
uzbekistan	ğŸ‡ºğŸ‡¿
v	âœŒ
valentine	ğŸ’
vanuatu	ğŸ‡»ğŸ‡º
vegetable	ğŸ…  ğŸ†
vehicle	ğŸš‚  ğŸšƒ  ğŸš„  ğŸš…  ğŸš†  ğŸ›²  ğŸš‡  ğŸšˆ  ğŸš‰  ğŸšŠ  ğŸš  ğŸš  ğŸš‹  ğŸšŒ  ğŸš  ğŸš 
ğŸš  ğŸš  ğŸš‘  ğŸš’  ğŸ›±  ğŸš“  ğŸš”  ğŸš•  ğŸš–  ğŸš—  ğŸš˜  ğŸš™  ğŸšš  ğŸš›  ğŸšœ  ğŸš² 
ğŸš³  ğŸš£  ğŸš¤  ğŸ›³  ğŸ›¥  ğŸš¢  ğŸ›¦  ğŸ›§  ğŸ›¨  ğŸ›©  ğŸ›ª  ğŸ›«  ğŸ›¬  ğŸš  ğŸšŸ  ğŸš  
ğŸš¡  ğŸš€  ğŸ›°
versus, vs	ğŸ†š
vertical	â¸
vhs, videocassette	ğŸ“¼
victory	âœŒ  ğŸ–”
video	ğŸ®  ğŸ“»  ğŸ“½  ğŸ“º  ğŸ“·  ğŸ“¸  ğŸ“¹  ğŸ“¼
violin	ğŸ»
virgin	ğŸ‡»ğŸ‡¬  ğŸ‡»ğŸ‡®
virgo	â™
volume	ğŸ”‰  ğŸ”Š
waning	ğŸŒ–  ğŸŒ˜
warning	âš 
wastebasket	ğŸ—‘
watch	âŒš
water	ğŸƒ  ğŸŒŠ  ğŸš°  ğŸš±  ğŸš¾
watermelon	ğŸ‰
wave	ğŸ‘‹  ğŸŒŠ  ğŸ”‰  ğŸ•©
waves	ğŸŒŠ  ğŸ”Š  ğŸ•ª  ğŸ•¬
waving	ğŸ‘‹  ğŸ³  ğŸ´
wavy	ã€°
waxing	ğŸŒ’  ğŸŒ”
wc	ğŸš»  ğŸš¾  ğŸ†
weapon	ğŸ—¡  ğŸ”ª  âš”  ğŸ”«  ğŸ›¡  â›¨
weary	ğŸ˜©  ğŸ™€
weather	ğŸ˜  ğŸ˜·  ğŸ’§  ğŸŒ»  ğŸŒ‹  ğŸŒ  ğŸŒƒ  ğŸŒ„  ğŸŒ…  ğŸŒ†  ğŸŒ‡  ğŸŒ‰  ğŸŒŠ  ğŸŒŒ  ğŸŒ‘  ğŸŒ’ 
ğŸŒ“  ğŸŒ”  ğŸŒ•  ğŸŒ–  ğŸŒ—  ğŸŒ˜  ğŸŒ™  ğŸŒš  ğŸŒ›  ğŸŒœ  ğŸŒ¡  â˜€  â˜¼  ğŸŒ  ğŸŒ  â˜ 
â›…  â›ˆ  ğŸŒ£  ğŸŒ¤  ğŸŒ¥  ğŸŒ¦  ğŸŒ§  ğŸŒ¨  ğŸŒ©  ğŸŒª  ğŸŒ«  ğŸŒ¬  ğŸŒ€  â›†  ğŸŒˆ  ğŸŒ‚ 
â˜‚  â˜”  â›±  ğŸŒ¢  â„  â˜ƒ  â›„  â›‡
web	ğŸ•¸
wedding	ğŸ‘°  ğŸ’’
weight	ğŸ‹  âš–
whale	ğŸ³  ğŸ‹
wheel	ğŸ¡  â˜¸
whew	ğŸ˜¥
white	â—ª
wind	ğŸƒ  ğŸŒ¬  ğŸ
window	ğŸ—”
wine	ğŸ·
wings	ğŸ’¸
wink	ğŸ˜‰  ğŸ˜œ
wired	ğŸ˜
wolf	ğŸº
woman	ğŸ‘©  ğŸ‘µ  ğŸ‘¯  ğŸ‘«  ğŸ‘­  ğŸ‘š  ğŸ‘¡  ğŸ‘¢  ğŸ‘’  ğŸšº
womenâ€™s	ğŸšº
word	ğŸ’¤  â›  #âƒ£  0âƒ£  1âƒ£  2âƒ£  3âƒ£  4âƒ£  5âƒ£  6âƒ£  7âƒ£  8âƒ£  9âƒ£  ğŸ”Ÿ  â€¼  â‰ 
â“  â”  â•  â—  â¢  ğŸ”  Â©  Â®  ğŸ”   ğŸ”¡  ğŸ”¢  ğŸ”£  ğŸ”¤  ğŸ—š  ğŸ—›  ğŸ…° 
ğŸ†  ğŸ…±  ğŸ†‘  ğŸ†’  ğŸ†“  â„¹  ğŸ†”  â“‚  ğŸ†•  ğŸ†–  ğŸ…¾  ğŸ†—  ğŸ…¿  ğŸ†˜  â„¢  ğŸ†™ 
ğŸ†š  ğŸˆ  ğŸˆ‚  ğŸˆ¹  ğŸ‰‘  ğŸˆ´  ğŸˆº  ğŸ‰  ğŸˆ¯  ğŸˆ·  ğŸˆ¶  ğŸˆµ  ğŸˆš  ğŸˆ¸  ãŠ—  ğŸˆ² 
ãŠ™  ğŸˆ³
worker	ğŸ‘·
world	ğŸ—º
worried	ğŸ˜Ÿ
wrench	ğŸ›   ğŸ”§
writing	âœ  ğŸ–
x	â›  âœ•  âœ–  ğŸ—™  âŒ
yellow	ğŸ’›  ğŸ”°
yemen	ğŸ‡¾ğŸ‡ª
yen	ğŸ’´  ğŸ’¹
zambia	ğŸ‡¿ğŸ‡²
zealand	ğŸ‡³ğŸ‡¿
zimbabwe	ğŸ‡¿ğŸ‡¼
zodiac	â™ˆ  â™‰  â™Š  â™‹  â™Œ  â™  â™  â™  â™  â™‘  â™’  â™“  â›
zzz	ğŸ’¤



























































