# Draft Emoji Annotations

# Finer-grained character annotations. For brevity, flags are not shown: they would have names of the associated countries. For details about the format and other information, see Unicode Emoji.

-1, thumbâ€™s down	ğŸ‘
0, zero	0âƒ£
00, oâ€™clock	ğŸ•›  ğŸ•  ğŸ•‘  ğŸ•’  ğŸ•“  ğŸ•”  ğŸ••  ğŸ•–  ğŸ•—  ğŸ•˜  ğŸ•™  ğŸ•š
1, one	ğŸ•  ğŸ•œ  1âƒ£
2, two	ğŸ•‘  ğŸ•  2âƒ£
3, three	ğŸ•’  ğŸ•  ğŸ”Š  3âƒ£  ğŸ–±
4, four	ğŸ€  ğŸ•“  ğŸ•Ÿ  4âƒ£
5, five	ğŸ•”  ğŸ•   5âƒ£
6, six	ğŸ••  ğŸ•¡  6âƒ£
7, seven	ğŸ•–  ğŸ•¢  7âƒ£
8, eight	ğŸ•—  ğŸ•£  ğŸ±  8âƒ£
9, nine	ğŸ•˜  ğŸ•¤  9âƒ£
10, ten	ğŸ•™  ğŸ•¥  ğŸ”Ÿ
11, eleven	ğŸ•š  ğŸ•¦
12, twelve	ğŸ•›  ğŸ•§
18, age restriction, eighteen, underage	ğŸ”
30, thirty	ğŸ•§  ğŸ•œ  ğŸ•  ğŸ•  ğŸ•Ÿ  ğŸ•   ğŸ•¡  ğŸ•¢  ğŸ•£  ğŸ•¤  ğŸ•¥  ğŸ•¦
100, hundred	ğŸ’¯
1234, numbers	ğŸ”¢
+1, thumbsâ€™s up	ğŸ‘
1:00	ğŸ•
1:30	ğŸ•œ
2:00	ğŸ•‘
2:30	ğŸ•
3:00	ğŸ•’
3:30	ğŸ•
4:00	ğŸ•“
4:30	ğŸ•Ÿ
5:00	ğŸ•”
5:30	ğŸ• 
6:00	ğŸ••
6:30	ğŸ•¡
7:00	ğŸ•–
7:30	ğŸ•¢
8 ball, billiard	ğŸ±
8:00	ğŸ•—
8:30	ğŸ•£
9:00	ğŸ•˜
9:30	ğŸ•¤
10:00	ğŸ•™
10:30	ğŸ•¥
11:00	ğŸ•š
11:30	ğŸ•¦
12:00	ğŸ•›
12:30	ğŸ•§
a	ğŸ…°
ab	ğŸ†
abc, alphabet	ğŸ”¤
abcd, lowercase	ğŸ”¡
access, wheelchair	â™¿
activity	ğŸ…  ğŸ©  ğŸ’’  ğŸ   ğŸ¡  ğŸ¢  ğŸª  ğŸ«  ğŸ­  ğŸ°  ğŸŒ   ğŸ¼  ğŸµ  ğŸ¶  ğŸ¤  ğŸ§ 
ğŸ·  ğŸ¸  ğŸ¹  ğŸº  ğŸ»  ğŸ¥  ğŸ¦  ğŸ¬  ğŸƒ  ğŸ„  ğŸ†  ğŸ‡  ğŸˆ  ğŸ‰  ğŸŠ  ğŸ‹ 
ğŸŒ  ğŸ  ğŸ  ğŸ  ğŸ  ğŸ‘  ğŸ“  ğŸ¨  ğŸ¯  ğŸ´  ğŸ’  ğŸš¬
admission, ticket	ğŸ«  ğŸŸ
aerial, ropeway, tramway	ğŸš¡
afghanistan	ğŸ‡¦ğŸ‡«
africa	ğŸŒ  ğŸ‡¿ğŸ‡¦
african, central	ğŸ‡¨ğŸ‡«
aid, helmet	â›‘
airplane	âœˆ  ğŸ›©  ğŸ›«  ğŸ›¬
Ã¥land	ğŸ‡¦ğŸ‡½
alarm	â°
albania	ğŸ‡¦ğŸ‡±
alembic, chemistry	âš—
algeria	ğŸ‡©ğŸ‡¿
alien, extraterrestrial, ufo	ğŸ‘½  ğŸ‘¾
ambulance	ğŸš‘
america, us, usa	ğŸ‡ºğŸ‡¸ğŸ‡ºğŸ‡² ğŸ‡»ğŸ‡®
american	ğŸˆ  ğŸ‡¦ğŸ‡¸
americas	ğŸŒ
amusement park	ğŸ¡  ğŸ¢
anchor	âš“  ğŸ”±
andorra	ğŸ‡¦ğŸ‡©
angel	ğŸ˜‡  ğŸ‘¼
angry, mad	ğŸ˜   ğŸ˜¡  ğŸ’¢  ğŸ—¯
angola	ğŸ‡¦ğŸ‡´
anguilla	ğŸ‡¦ğŸ‡®
anguished	ğŸ˜§
animal	ğŸµ  ğŸ’  ğŸ¶  ğŸ•  ğŸ©  ğŸº  ğŸ±  ğŸ˜¸  ğŸ˜¹  ğŸ˜º  ğŸ˜»  ğŸ˜¼  ğŸ˜½  ğŸ˜¾  ğŸ˜¿  ğŸ™€ 
ğŸˆ  ğŸ¯  ğŸ…  ğŸ†  ğŸ´  ğŸ  ğŸ®  ğŸ‚  ğŸƒ  ğŸ„  ğŸ·  ğŸ–  ğŸ—  ğŸ½  ğŸ  ğŸ‘ 
ğŸ  ğŸª  ğŸ«  ğŸ˜  ğŸ­  ğŸ  ğŸ€  ğŸ¹  ğŸ°  ğŸ‡  ğŸ¿  ğŸ»  ğŸ¨  ğŸ¼  ğŸ¾  ğŸ” 
ğŸ“  ğŸ£  ğŸ¤  ğŸ¥  ğŸ¦  ğŸ§  ğŸ•Š  ğŸ¸  ğŸŠ  ğŸ  ğŸ¢  ğŸ²  ğŸ‰  ğŸ³  ğŸ‹  ğŸ¬ 
ğŸŸ  ğŸ   ğŸ¡  ğŸ™  ğŸš  ğŸŒ  ğŸ›  ğŸœ  ğŸ  ğŸ  ğŸ•·  ğŸ•¸  ğŸ‘½  ğŸ‘¾
ant	ğŸœ
antarctica	ğŸ‡¦ğŸ‡¶
antenna	ğŸ“¶  ğŸ“¡
anticlockwise, counterclockwise, withershins	ğŸ”„
antigua, barbuda	ğŸ‡¦ğŸ‡¬
antilles, curacao, curaÃ§ao	ğŸ‡¨ğŸ‡¼
apology, sorry	ğŸ™‡
apple	ğŸ  ğŸ
aquarius	â™’
arab	ğŸ‡ªğŸ‡¬  ğŸ‡±ğŸ‡¾  ğŸ‡¸ğŸ‡¾  ğŸ‡¦ğŸ‡ª
arabia, saudi	ğŸ‡¸ğŸ‡¦
argentina	ğŸ‡¦ğŸ‡·
aries	â™ˆ
armenia	ğŸ‡¦ğŸ‡²
arrivals, arriving, landing	ğŸ›¬
arrow	ğŸ’˜  ğŸ”€  ğŸ”  ğŸ”‚  â–¶  â©  â­  â¯  â—€  âª  â®  ğŸ”¼  â«  ğŸ”½  â¬  ğŸ“² 
ğŸ“©  â¬†  â†—  â¡  â†˜  â¬‡  â†™  â¬…  â†–  â†•  â†”  â†©  â†ª  â¤´  â¤µ  ğŸ”ƒ 
ğŸ”„  ğŸ”™  ğŸ”š  ğŸ”›  ğŸ”œ  ğŸ”
art	ğŸ­  ğŸ¨  ğŸ–¼
aruba	ğŸ‡¦ğŸ‡¼
ascension	ğŸ‡¦ğŸ‡¨  ğŸ‡¸ğŸ‡­
asia	ğŸŒ
ask, folded, please, pray, thanks	ğŸ™
asterisk	*âƒ£  âœ³
astonished, shocked, totally	ğŸ˜²
atheist, atom	âš›
athletic, sneaker	ğŸ‘Ÿ
atm, automated, teller	ğŸ§
aubergine, eggplant	ğŸ†
australia	ğŸŒ  ğŸ‡¦ğŸ‡º
austria	ğŸ‡¦ğŸ‡¹
automobile	ğŸš—  ğŸš˜
azerbaijan	ğŸ‡¦ğŸ‡¿
b	ğŸ…±
baby	ğŸ‘¶  ğŸ‘¼  ğŸ£  ğŸ¤  ğŸ¥  ğŸ¼  ğŸš¼
back	ğŸ”™
backhand	ğŸ‘ˆ  ğŸ‘‰  ğŸ‘†  ğŸ‘‡
bactrian	ğŸ«
badge, name	ğŸ“›
bag	ğŸ‘œ  ğŸ‘  ğŸ›  ğŸ’°  ğŸ’
baggage	ğŸ›„  ğŸ›…
bahamas	ğŸ‡§ğŸ‡¸
bahrain	ğŸ‡§ğŸ‡­
balance, justice, scales	âš–
ball	ğŸ™  âš½  âš¾  ğŸ€  ğŸˆ  ğŸ‰  ğŸ¾  ğŸ±  ğŸ³  ğŸŒ  â›¹  ğŸŠ  ğŸ”®
balloon	ğŸ’¬  ğŸ’­  ğŸ—¯  ğŸˆ
ballot	ğŸ—³  â˜‘
ballpoint	ğŸ–Š
bamboo, pine	ğŸ
banana	ğŸŒ
bangbang	â€¼
bangladesh	ğŸ‡§ğŸ‡©
bank	ğŸ¦  ğŸ§  ğŸ’´  ğŸ’µ  ğŸ’¶  ğŸ’·  ğŸ’¸  ğŸ’±  ğŸ’³  ğŸ’¹
banknote, bill	ğŸ’´  ğŸ’µ  ğŸ’¶  ğŸ’·  ğŸ’¸
banner	ğŸ‹
bar	ğŸ«  ğŸ¶  ğŸ·  ğŸ¸  ğŸ¹  ğŸº  ğŸ»  â¸  ğŸ“¶  ğŸ®  ğŸ“Š
barbados	ğŸ‡§ğŸ‡§
barber, haircut	ğŸ’‡  ğŸ’ˆ
barrier	ğŸš§
barthelemy, barthÃ©lemy	ğŸ‡§ğŸ‡±
baseball	âš¾
basketball, hoop	ğŸ€
bath, bathtub	ğŸ›€  ğŸ›
battery	ğŸ”‹
beach	ğŸ–
beacon	ğŸš¨
bear	ğŸ»  ğŸ¨
beating, heartbeat, pulsating	ğŸ’“
beauty, parlor	ğŸ’‡
bed	ğŸ›
bee, honeybee	ğŸ
beer, mug	ğŸº  ğŸ»
beetle, lady beetle, ladybird, ladybug	ğŸ
beginner, chevron	ğŸ”°
belarus	ğŸ‡§ğŸ‡¾
belgium	ğŸ‡§ğŸ‡ª
belize	ğŸ‡§ğŸ‡¿
bell	ğŸ›  ğŸ””  ğŸ”•  ğŸ
bellhop	ğŸ›
benin	ğŸ‡§ğŸ‡¯
bento	ğŸ±
bermuda	ğŸ‡§ğŸ‡²
berry, strawberry	ğŸ“
beverage	â˜•  ğŸµ  ğŸ¶  ğŸ·
bhutan	ğŸ‡§ğŸ‡¹
biceps, flex, muscle	ğŸ’ª
bicycle, bike	ğŸš²  ğŸš³  ğŸš´  ğŸšµ
bicyclist, cyclist	ğŸš´  ğŸšµ
bikini	ğŸ‘™
biohazard	â˜£
bird	ğŸ¦  ğŸ•Š
birthday	ğŸ‚
bissau	ğŸ‡¬ğŸ‡¼
blond	ğŸ‘±
blood	ğŸ…°  ğŸ†  ğŸ…±  ğŸ…¾
blossom	ğŸŒ¸  ğŸŒ¼
blow	ğŸƒ  ğŸŒ¬
blowfish	ğŸ¡
blu-ray, cd	ğŸ’¿
blue	ğŸ˜°  ğŸ’™  ğŸ“˜  ğŸ”·  ğŸ”¹  ğŸ”µ
blush	ğŸ˜Š
boar	ğŸ—
boat	â›µ  ğŸš£  ğŸš¤  â›´  ğŸ›¥
body	ğŸ™Œ  ğŸ™  ğŸ‘ˆ  ğŸ‘‰  â˜  ğŸ‘†  ğŸ–•  ğŸ‘‡  âœŒ  ğŸ––  âœŠ  âœ‹  ğŸ‘Š  ğŸ‘‹  ğŸ‘Œ  ğŸ‘ 
ğŸ‘  ğŸ‘  ğŸ‘  âœ  ğŸ–  ğŸ’…  ğŸ’ª  ğŸ‘£  ğŸ‘€  ğŸ‘  ğŸ‘‚  ğŸ‘ƒ  ğŸ‘…  ğŸ’€  â˜   ğŸ‘„
bolivia	ğŸ‡§ğŸ‡´
bolt, nut	ğŸ”©
bomb	ğŸ’£
bonaire, caribbean, eustatius, saba	ğŸ‡§ğŸ‡¶
bone	ğŸ–  ğŸ—
book	ğŸ“”  ğŸ“•  ğŸ“–  ğŸ“—  ğŸ“˜  ğŸ“™  ğŸ“š
bookmark	ğŸ“‘  ğŸ”–
books	ğŸ“š
boom, collision	ğŸ’¥
boot	ğŸ‘¢
bosnia, herzegovina	ğŸ‡§ğŸ‡¦
botswana	ğŸ‡§ğŸ‡¼
bottle	ğŸ¶  ğŸ¼
bouquet	ğŸ’
bouvet	ğŸ‡§ğŸ‡»
bow	ğŸ™‡  ğŸ™
bowl, noodle, ramen	ğŸœ
bowling	ğŸ³
box	ğŸ±  ğŸ  ğŸ“¤  ğŸ“¥  ğŸ“¦  ğŸ—ƒ  ğŸ—³  â˜‘
boy	ğŸ‘¦
branch	â¸™
brazil	ğŸ‡§ğŸ‡·
brazzaville	ğŸ‡¨ğŸ‡¬
bread, loaf	ğŸ
break, broken	ğŸ’”
bride, veil	ğŸ‘°
bridge	ğŸŒ‰
briefcase	ğŸ’¼
bright	ğŸ˜  â˜€  ğŸŒ  ğŸŒ  ğŸ”†
brightness	ğŸ”…  ğŸ”†
britain, cornwall, great, kingdom, scotland, wales	ğŸ‡¬ğŸ‡§
british	ğŸ‡®ğŸ‡´  ğŸ‡»ğŸ‡¬
brunei, darussalam	ğŸ‡§ğŸ‡³
bubble	ğŸ’¬  ğŸ’­  ğŸ—¯
buddhist, dharma	â˜¸
buffalo	ğŸƒ
bug	ğŸ›
building	ğŸ›  ğŸ—  ğŸ˜  ğŸ™  ğŸš  ğŸ   ğŸ¡  â›ª  ğŸ¢  ğŸ£  ğŸ¤  ğŸ¥  ğŸ¦  ğŸ¨  ğŸ©  ğŸª 
ğŸ«  ğŸ¬  ğŸ­  ğŸ¯  ğŸ°  ğŸŒ†  ğŸŒ‡
bulb, idea	ğŸ’¡
bulgaria	ğŸ‡§ğŸ‡¬
bullâ€™s eye, dart, hit, target	ğŸ¯
bullet	ğŸš…
bunny	ğŸ‘¯  ğŸ°  ğŸ‡
burger, hamburger	ğŸ”
burkina, faso	ğŸ‡§ğŸ‡«
burma, myanmar	ğŸ‡²ğŸ‡²
burundi	ğŸ‡§ğŸ‡®
bus	ğŸšŒ  ğŸš  ğŸš  ğŸš  ğŸš
business	ğŸ•´
busstop	ğŸš
bust	ğŸ‘¤  ğŸ‘¥
button	ğŸ”¼  ğŸ”½  ğŸ–±  ğŸ”˜  ğŸ”²  ğŸ”³
cabinet	ğŸ—„
cable, gondola	ğŸš   ğŸš¡
cabo, cape, verde	ğŸ‡¨ğŸ‡»
cactus	ğŸŒµ
caicos, turks	ğŸ‡¹ğŸ‡¨
cake, pastry	ğŸ¥  ğŸ‚  ğŸ°
calendar	ğŸ“…  ğŸ“†  ğŸ—“
call	ğŸ“²
cambodia	ğŸ‡°ğŸ‡­
camel, hump	ğŸª  ğŸ«
camera	ğŸ¥  ğŸ¦  ğŸ“·  ğŸ“¸  ğŸ“¹
cameroon	ğŸ‡¨ğŸ‡²
camping	ğŸ•  â›º
canada	ğŸ‡¨ğŸ‡¦
canary	ğŸ‡®ğŸ‡¨
cancel, multiplication, multiply, x	âœ–  âŒ
cancer	â™‹
candle	ğŸ•¯
candy	ğŸ¬  ğŸ­
cap, graduation	ğŸ“
capricorn	â™‘
car	ğŸšƒ  ğŸš  ğŸš‹  ğŸš“  ğŸš”  ğŸš—  ğŸš˜  ğŸ  ğŸš¨  ğŸš¡
card	â™   â™¥  â™¦  â™£  ğŸƒ  ğŸ´  ğŸ’³  ğŸ—‚  ğŸ“‡  ğŸ—ƒ
cardinal	â¬†  â¡  â¬‡  â¬…
care, manicure, nail, polish	ğŸ’…
carousel	ğŸ 
carp, streamer	ğŸ
castle	ğŸ¯  ğŸ°
cat	ğŸ±  ğŸ˜¸  ğŸ˜¹  ğŸ˜º  ğŸ˜»  ğŸ˜¼  ğŸ˜½  ğŸ˜¾  ğŸ˜¿  ğŸ™€  ğŸˆ
cayman	ğŸ‡°ğŸ‡¾
celebration	ğŸ…  ğŸ™Œ  ğŸ‚  ğŸƒ  ğŸ„  ğŸ†  ğŸ‡  ğŸˆ  ğŸ‰  ğŸŠ  ğŸ‹  ğŸŒ  ğŸ  ğŸ  ğŸ  ğŸ 
ğŸ‘  ğŸ“  ğŸ€  ğŸ  ğŸ–  ğŸ—
cell	ğŸ“±  ğŸ“³  ğŸ“´  ğŸ“²  ğŸ“µ
ceremony	ğŸ‘
ceuta, melilla	ğŸ‡ªğŸ‡¦
chad	ğŸ‡¹ğŸ‡©
chain	â›“
chair, seat	ğŸ’º
changing	ğŸš¼
chapel	ğŸ’’
chart, graph	ğŸ’¹  ğŸ“ˆ  ğŸ“‰  ğŸ“Š
check	âœ…  â˜‘  âœ”
check-in, departure, departures	ğŸ›«
checkered, chequered	ğŸ
cheering, megaphone	ğŸ“£
cherry	ğŸŒ¸  ğŸ’
chestnut	ğŸŒ°
chick	ğŸ£  ğŸ¤  ğŸ¥
chicken	ğŸ”  ğŸ—
child	ğŸ‘ª  ğŸš¸
chile	ğŸ‡¨ğŸ‡±
chime	ğŸ
china	ğŸ‡¨ğŸ‡³  ğŸ‡­ğŸ‡°  ğŸ‡²ğŸ‡´  ğŸ‡¹ğŸ‡¼
chinese	ğŸ‰‘  ğŸˆ´  ğŸˆº  ğŸˆµ  ğŸˆ¸  ğŸˆ³
chipmunk	ğŸ¿
chocolate	ğŸ«
christian	â›ª  âœ  â˜¦
christmas	ğŸ…  ğŸ„  ğŸ‡¨ğŸ‡½
church	â›ª
cinema	ğŸ¥  ğŸ¦  ğŸ“½  ğŸ
circle	âº  â­•  âšª  âš«  ğŸ”´  ğŸ”µ  â“‚
circus	ğŸª
citrus, lemon	ğŸ‹
city	ğŸ™  ğŸŒ†  ğŸ‡»ğŸ‡¦
cl	ğŸ†‘
claim	ğŸ›„
clap	ğŸ‘
clapper	ğŸ¬
classical	ğŸ›
clenched, fist, punch	âœŠ  ğŸ‘Š
clink	ğŸ»
clipboard	ğŸ“‹
clipperton	ğŸ‡¨ğŸ‡µ
clock	âŒš  â°  â±  â²  ğŸ•°  ğŸ•›  ğŸ•§  ğŸ•  ğŸ•œ  ğŸ•‘  ğŸ•  ğŸ•’  ğŸ•  ğŸ•“  ğŸ•Ÿ  ğŸ•” 
ğŸ•   ğŸ••  ğŸ•¡  ğŸ•–  ğŸ•¢  ğŸ•—  ğŸ•£  ğŸ•˜  ğŸ•¤  ğŸ•™  ğŸ•¥  ğŸ•š  ğŸ•¦
clockwise	ğŸ”  ğŸ”‚  ğŸ”ƒ
closed	ğŸ˜š  ğŸ“•  ğŸ“«  ğŸ“ª  ğŸ”’  ğŸ”
closet	ğŸš¾
clothing	ğŸ‘£  ğŸ‘“  ğŸ‘”  ğŸ‘•  ğŸ‘–  ğŸ‘—  ğŸ‘˜  ğŸ‘™  ğŸ‘š  ğŸ‘›  ğŸ‘œ  ğŸ‘  ğŸ‘  ğŸ‘Ÿ  ğŸ‘   ğŸ‘¡ 
ğŸ‘¢  ğŸ‘‘  ğŸ‘’
cloud	â˜  â›…  â›ˆ  ğŸŒ¤  ğŸŒ¥  ğŸŒ¦  ğŸŒ§  ğŸŒ¨  ğŸŒ©  ğŸŒª  ğŸŒ«  ğŸŒ¬
clover	ğŸ€
club, clubs	â™£
clue	ğŸ—
coast, cote, cÃ´te, ivoire, ivory	ğŸ‡¨ğŸ‡®
coaster, roller	ğŸ¢
cocktail	ğŸ¸
cocos, keeling	ğŸ‡¨ğŸ‡¨
coffee	â˜•
coffin	âš°
coin, purse	ğŸ‘›
cold	ğŸ˜…  ğŸ˜“  ğŸ˜°  ğŸ˜·  ğŸ’§  ğŸ”  ğŸŒ¨  â„  â˜ƒ  â›„
colombia	ğŸ‡¨ğŸ‡´
comet	â˜„
comic	ğŸ’ª  ğŸ’§  ğŸ’¤  ğŸ’¢  ğŸ’£  ğŸ’¥  ğŸ’¦  ğŸ’¨  ğŸ’«  ğŸ’¬  ğŸ’­  ğŸ’©  ğŸ’¡  ğŸ’ 
communication	ğŸ“¢  ğŸ“£  ğŸ“¯  ğŸ“±  ğŸ“³  ğŸ“´  ğŸ“²  ğŸ“µ  ğŸ“  ğŸ“¶  ğŸ“Ÿ  ğŸ“   ğŸ“°  ğŸ“§  ğŸ“¨  ğŸ“© 
ğŸ“¤  ğŸ“¥  ğŸ“¦  ğŸ“«  ğŸ“ª  ğŸ“¬  ğŸ“­  ğŸ“®  ğŸ–‹  ğŸ–Š  ğŸ–Œ  ğŸ–  ğŸ“  ğŸ–‡  ğŸ“¡
comoros	ğŸ‡°ğŸ‡²
compression, vice	ğŸ—œ
computer	ğŸ’»  ğŸ–¥  ğŸ–¨  âŒ¨  ğŸ–±  ğŸ–²  ğŸ’½  ğŸ’¾  ğŸ’¿  ğŸ“€
confetti	ğŸŠ
confounded	ğŸ˜–
confused	ğŸ˜•
congo	ğŸ‡¨ğŸ‡¬  ğŸ‡¨ğŸ‡©
congratulation, congratulations	ãŠ—
construction	ğŸ‘·  ğŸ—  ğŸš§
control	ğŸ›‚  ğŸ›
controller	ğŸ®
convenience	ğŸª
cook	ğŸ‡¨ğŸ‡°
cooked	ğŸš
cookie	ğŸª
cooking	ğŸ³  ğŸ”ª
cool	ğŸ˜  ğŸ†’
cop, officer	ğŸ‘®
copyright	Â©
corn, maize, maze	ğŸŒ½
cosmetics	ğŸ’…  ğŸ’„
costa, rica	ğŸ‡¨ğŸ‡·
couch, lamp	ğŸ›‹
couple	ğŸ’  ğŸ’‘  ğŸ‘«  ğŸ‘¬  ğŸ‘­
cover, decorated	ğŸ“”
cow	ğŸ®  ğŸ„
cracker	ğŸ˜
crayon	ğŸ–
cream	ğŸ¦  ğŸ¨
creature	ğŸ‘¹  ğŸ‘º  ğŸ‘»  ğŸ‘½  ğŸ‘¾
credit	ğŸ’³
crescent	ğŸŒ’  ğŸŒ˜  ğŸŒ™
croatia	ğŸ‡­ğŸ‡·
crocodile	ğŸŠ
cross	â›‘  â›ª  ğŸŒ  âœ  â˜¦
crossbones	â˜ 
crossed	ğŸ”€  ğŸŒ  âš”
crossing	ğŸš¸
crown, king, queen	ğŸ‘‘
cry, sad	ğŸ˜¢  ğŸ˜­  ğŸ˜¿
crystal	ğŸ”®
cuba	ğŸ‡¨ğŸ‡º
cunha, tristan	ğŸ‡¸ğŸ‡­  ğŸ‡¹ğŸ‡¦
cup	ğŸµ  ğŸ¶
cupid	ğŸ’˜
curl	ğŸ“ƒ  â°  â¿
currency	ğŸ’´  ğŸ’µ  ğŸ’¶  ğŸ’·  ğŸ’±  ğŸ’²  ğŸ’¹
curry	ğŸ›
custard, pudding	ğŸ®
customs	ğŸ›ƒ
cyclone, twister, typhoon	ğŸŒ€
cyprus	ğŸ‡¨ğŸ‡¾
czech	ğŸ‡¨ğŸ‡¿
dagger	ğŸ—¡
dancer	ğŸ‘¯  ğŸ’ƒ
danger, voltage, zap	âš¡
dango	ğŸ¡
dark	ğŸ•¶  ğŸŒ‘
dash	ğŸ’¨  ã€°
date	ğŸ“…
david, jew, jewish	âœ¡
dazed, flushed	ğŸ˜³
deadpan, neutral	ğŸ˜
death	ğŸ’€  â˜   âš°  âš±
deciduous, shedding	ğŸŒ³
default-text-style	â˜º  â˜¹  ğŸ•µ  ğŸ—£  ğŸ•´  â˜  âœŒ  âœ  ğŸ–  ğŸ‘  â˜   â¤  â£  ğŸ•³  ğŸ—¯  ğŸ•¶ 
â›‘  ğŸ¿  ğŸ•Š  ğŸ•·  ğŸ•¸  ğŸµ  â¸™  â˜˜  ğŸŒ¶  ğŸ½  ğŸ—º  ğŸ”  â›°  ğŸ•  ğŸ–  ğŸœ 
ğŸ  ğŸ  ğŸŸ  ğŸ›  ğŸ—  ğŸ˜  ğŸ™  ğŸš  â™¨  ğŸ  ğŸ  ğŸ›£  ğŸ›¤  âˆ  ğŸ›³  â›´ 
ğŸ›¥  âœˆ  ğŸ›©  ğŸ›°  âš   ğŸ›  ğŸ›  ğŸ›‹  ğŸ›  â±  â²  ğŸ•°  ğŸŒ¡  â˜€  â˜  â›ˆ 
ğŸŒ¤  ğŸŒ¥  ğŸŒ¦  ğŸŒ§  ğŸŒ¨  ğŸŒ©  ğŸŒª  ğŸŒ«  ğŸŒ¬  â˜‚  â›±  â„  â˜ƒ  â˜„  â™   â™¥ 
â™¦  â™£  ğŸ•¹  ğŸŒ  â›¸  â›·  â›¹  ğŸ‹  â–¶  â­  â¯  â—€  â®  â¸  â¹  âº 
â  ğŸ™  ğŸš  ğŸ›  â˜  #âƒ£  *âƒ£  0âƒ£  1âƒ£  2âƒ£  3âƒ£  4âƒ£  5âƒ£  6âƒ£  7âƒ£  8âƒ£ 
9âƒ£  ğŸ“½  ğŸ•¯  ğŸ–  ğŸ—  ğŸ  ğŸŸ  ğŸ·  ğŸ—  ğŸ–¼  âœ‰  âœ  âœ’  ğŸ–‹  ğŸ–Š  ğŸ–Œ 
ğŸ–  ğŸ–¥  ğŸ–¨  âŒ¨  ğŸ–±  ğŸ–²  ğŸ—‚  ğŸ—’  ğŸ—“  ğŸ–‡  âœ‚  ğŸ—ƒ  ğŸ—„  ğŸ—‘  ğŸ—  â› 
âš’  ğŸ›   âš™  ğŸ—œ  âš—  âš–  ğŸ—¡  âš”  ğŸ›¡  â›“  ğŸ›¢  ğŸ—³  âš›  âšœ  âš°  âš± 
ğŸ³  â¬†  â†—  â¡  â†˜  â¬‡  â†™  â¬…  â†–  â†•  â†”  â†©  â†ª  â¤´  â¤µ  ğŸ•‰ 
âœ¡  â˜¸  â˜¯  âœ  â˜¦  â›©  â˜ª  â˜®  â˜¢  â˜£  â™»  â˜‘  âœ”  âœ–  ã€½  âœ³ 
âœ´  â‡  â–ª  â–«  â—»  â—¼  â€¼  â‰  ã€°  Â©  Â®  ğŸ…°  ğŸ…±  â„¹  â“‚  ğŸ…¾ 
ğŸ…¿  â„¢  ğŸˆ‚  ğŸˆ·  ãŠ—  ãŠ™
dejected, pensive	ğŸ˜”
delicious, savouring, um, yum	ğŸ˜‹
delivery	ğŸšš
denmark	ğŸ‡©ğŸ‡°
department	ğŸ¬
derelict	ğŸš
desert	ğŸœ  ğŸ
desktop	ğŸ–¥
dessert	ğŸ¡  ğŸ¦  ğŸ§  ğŸ¨  ğŸ©  ğŸª  ğŸ‚  ğŸ°  ğŸ«  ğŸ¬  ğŸ­  ğŸ®
devil, imp	ğŸ‘¿
dialog, speech	ğŸ’¬
diamond	â™¦  ğŸ’  ğŸ’  ğŸ”¶  ğŸ”·  ğŸ”¸  ğŸ”¹  ğŸ’ 
diamonds	â™¦
dice, die	ğŸ²
diego, garcia	ğŸ‡©ğŸ‡¬
dim	ğŸ”…
direction	â¬†  â†—  â¡  â†˜  â¬‡  â†™  â¬…  â†–
disappointed	ğŸ˜  ğŸ˜¥
disc	ğŸ’½  ğŸ’¾  ğŸ’¿  ğŸ“€
dish	ğŸ“¡
disk, floppy	ğŸ’¾
dividers	ğŸ—‚
division	â—
dizzy	ğŸ˜µ  ğŸ’«  ğŸŒ€
djibouti	ğŸ‡©ğŸ‡¯
doctor, medicine	ğŸ˜·  ğŸ¥  ğŸ’‰  ğŸ’Š
document, page	ğŸ“ƒ  ğŸ“„
dog	ğŸ¶  ğŸ•  ğŸ©
doll, festival	ğŸ
dollar	ğŸ’°  ğŸ’µ  ğŸ’¸  ğŸ’²
dolphin, flipper	ğŸ¬
dominica	ğŸ‡©ğŸ‡²  ğŸ‡©ğŸ‡´
dominican	ğŸ‡©ğŸ‡´
donut, doughnut	ğŸ©
door	ğŸšª
double	â©  âª  â«  â¬  â¸  â¿
dove	ğŸ•Š
down	ğŸ‘‡  ğŸ‘  ğŸ”½  â¬  ğŸ“©  ğŸ“‰  â¬‡  â¤µ  ğŸ”»
dragon	ğŸ²  ğŸ‰
dress	ğŸ‘—
drink	â˜•  ğŸµ  ğŸ¶  ğŸ·  ğŸ¸  ğŸ¹  ğŸº  ğŸ»  ğŸ¼  ğŸš°  ğŸš±
dromedary	ğŸª
drop	ğŸ’§  â˜”
drum, oil	ğŸ›¢
dung, poo, poop	ğŸ’©
dusk, sunset	ğŸŒ†  ğŸŒ‡
dutch, maarten	ğŸ‡¸ğŸ‡½
dvd	ğŸ’¿  ğŸ“€
e-mail, email	âœ‰  ğŸ“§  ğŸ“¨  ğŸ“©
ear	ğŸ‘¯  ğŸ‘‚  ğŸŒ¾  ğŸŒ½
earbud, headphone	ğŸ§
earth, globe	ğŸŒ  ğŸŒ  ğŸŒ  ğŸŒ
east	ğŸ‡¹ğŸ‡±  â¡
ecuador	ğŸ‡ªğŸ‡¨
education	âœ  ğŸ«  ğŸ“  ğŸ“”  ğŸ“•  ğŸ“–  ğŸ“—  ğŸ“˜  ğŸ“™  ğŸ“š  ğŸ’
egg, frying, pan	ğŸ³
egypt	ğŸ‡ªğŸ‡¬
eject	â
el salvador	ğŸ‡¸ğŸ‡»
electric	ğŸšƒ  ğŸ’¡  ğŸ”¦  ğŸ”Œ  âš¡
electricity	ğŸ”Œ  âš¡
elephant	ğŸ˜
emblem, trident	ğŸ”±
emirates	ğŸ‡¦ğŸ‡ª
emotion	ğŸ’‹  ğŸ’˜  â¤  ğŸ’“  ğŸ’”  ğŸ’•  ğŸ’–  ğŸ’—  ğŸ’™  ğŸ’š  ğŸ’›  ğŸ’œ  ğŸ’  ğŸ’  ğŸ’Ÿ  â£ 
ğŸ’Œ  ğŸ’§  ğŸ’¤  ğŸ’¢  ğŸ’£  ğŸ’¥  ğŸ’¦  ğŸ’¨  ğŸ’«  ğŸ’¬  ğŸ’­  ğŸ—¯  â™¥  ğŸ’ 
end	ğŸ”š
engine	ğŸš‚  ğŸš’
entertainment	ğŸ©  ğŸ   ğŸ¡  ğŸ¢  ğŸª  ğŸ«  ğŸ­  ğŸ®  ğŸ•¹  ğŸ£  ğŸ¤  ğŸ§  ğŸ¥  ğŸ¦  ğŸ¬  ğŸ“½ 
ğŸ“º  ğŸ¨  ğŸ  ğŸŸ
entry	ğŸš«  â›”
envelope	âœ‰  ğŸ“¨  ğŸ“©
equatorial	ğŸ‡¬ğŸ‡¶
eritrea	ğŸ‡ªğŸ‡·
eruption, volcano	ğŸŒ‹
estonia	ğŸ‡ªğŸ‡ª
ethiopia	ğŸ‡ªğŸ‡¹
euro	ğŸ’¶
europe	ğŸŒ
european	ğŸ¤  ğŸ°  ğŸ‡ªğŸ‡º
evening, landscape	ğŸŒ†
evergreen	ğŸŒ²
evil	ğŸ™ˆ  ğŸ™‰  ğŸ™Š
exchange	ğŸ’±
excited	ğŸ’–  ğŸ’—
exclamation	â£  â€¼  â‰  â•  â—
expressionless, inexpressive, unexpressive	ğŸ˜‘
eye	ğŸ˜  ğŸ˜„  ğŸ˜Š  ğŸ˜  ğŸ˜  ğŸ˜™  ğŸ˜š  ğŸ˜œ  ğŸ˜  ğŸ‘€  ğŸ‘  ğŸ‘“  ğŸ•¶  ğŸ˜¸  ğŸ˜»  ğŸ˜½ 
ğŸ¯
eyeglasses	ğŸ‘“
eyewear, glasses	ğŸ˜  ğŸ‘“  ğŸ•¶
face	â˜º  â˜¹  ğŸ™  ğŸ™‚  ğŸ˜€  ğŸ˜  ğŸ˜‚  ğŸ˜ƒ  ğŸ˜„  ğŸ˜…  ğŸ˜†  ğŸ˜‰  ğŸ˜Š  ğŸ˜‹  ğŸ˜Œ  ğŸ˜ 
ğŸ˜  ğŸ˜  ğŸ˜  ğŸ˜‘  ğŸ˜’  ğŸ˜“  ğŸ˜”  ğŸ˜•  ğŸ˜–  ğŸ˜—  ğŸ˜˜  ğŸ˜™  ğŸ˜š  ğŸ˜›  ğŸ˜œ  ğŸ˜ 
ğŸ˜  ğŸ˜Ÿ  ğŸ˜   ğŸ˜¡  ğŸ˜¢  ğŸ˜£  ğŸ˜¤  ğŸ˜¥  ğŸ˜¦  ğŸ˜§  ğŸ˜¨  ğŸ˜©  ğŸ˜ª  ğŸ˜«  ğŸ˜¬  ğŸ˜­ 
ğŸ˜®  ğŸ˜¯  ğŸ˜°  ğŸ˜±  ğŸ˜²  ğŸ˜³  ğŸ˜´  ğŸ˜µ  ğŸ˜¶  ğŸ˜·  ğŸ˜‡  ğŸ˜ˆ  ğŸ‘¿  ğŸ‘¼  ğŸ’†  ğŸ™ 
ğŸ™…  ğŸ™†  ğŸ—£  ğŸ‘€  ğŸ’€  â˜   ğŸµ  ğŸ™ˆ  ğŸ™‰  ğŸ™Š  ğŸ¶  ğŸº  ğŸ±  ğŸ˜¸  ğŸ˜¹  ğŸ˜º 
ğŸ˜»  ğŸ˜¼  ğŸ˜½  ğŸ˜¾  ğŸ˜¿  ğŸ™€  ğŸ¯  ğŸ´  ğŸ®  ğŸ·  ğŸ½  ğŸ­  ğŸ¹  ğŸ°  ğŸ»  ğŸ¼ 
ğŸ¸  ğŸ²  ğŸ³  ğŸ‘¹  ğŸ‘º  ğŸ‘»  ğŸ‘½  ğŸ‘¾  ğŸ—¿  ğŸ­  ğŸ•›  ğŸ•§  ğŸ•  ğŸ•œ  ğŸ•‘  ğŸ• 
ğŸ•’  ğŸ•  ğŸ•“  ğŸ•Ÿ  ğŸ•”  ğŸ•   ğŸ••  ğŸ•¡  ğŸ•–  ğŸ•¢  ğŸ•—  ğŸ•£  ğŸ•˜  ğŸ•¤  ğŸ•™  ğŸ•¥ 
ğŸ•š  ğŸ•¦  ğŸŒš  ğŸŒ›  ğŸŒœ  ğŸŒ  ğŸŒ  ğŸŒ¬
factory	ğŸ­
faeroe, faroe	ğŸ‡«ğŸ‡´
fairy tale	ğŸ‘¿  ğŸ‘¸  ğŸ‘¼  ğŸ’€  ğŸ²  ğŸ‰  ğŸ‘¹  ğŸ‘º  ğŸ‘»  ğŸ‘½  ğŸ‘¾
falkland, islas, malvinas	ğŸ‡«ğŸ‡°
falling	ğŸ  ğŸ‚  ğŸŒ 
family, mother	ğŸ‘ª
fantasy	ğŸ˜‡  ğŸ˜ˆ  ğŸ‘¿  ğŸ‘¸  ğŸ…  ğŸ‘¼  ğŸ‘¹  ğŸ‘º  ğŸ‘»  ğŸ‘½  ğŸ‘¾  ğŸš€  ğŸ”®
fast, forward	â©
father	ğŸ…  ğŸ‘ª
fax	ğŸ“ 
fear, fearful, scared	ğŸ˜¨  ğŸ˜±
feet, paw	ğŸ¾
ferris	ğŸ¡
ferry	â›´
fiji	ğŸ‡«ğŸ‡¯
file	ğŸ“  ğŸ“‚  ğŸ—ƒ  ğŸ—„
film	ğŸ¦  ğŸ“½  ğŸ
finger	ğŸ‘ˆ  ğŸ‘‰  â˜  ğŸ‘†  ğŸ–•  ğŸ‘‡  ğŸ––  ğŸ–
finland	ğŸ‡«ğŸ‡®
fire	ğŸš’  ğŸ”¥
fireworks	ğŸ†  ğŸ‡
fish	ğŸŸ  ğŸ   ğŸ¡  ğŸ¥  ğŸ£
fitz-minimal	ğŸ‘¦  ğŸ‘§  ğŸ‘¨  ğŸ‘©  ğŸ‘´  ğŸ‘µ  ğŸ‘¶  ğŸ‘±  ğŸ‘®  ğŸ‘²  ğŸ‘³  ğŸ‘·  ğŸ‘¸  ğŸ’‚  ğŸ…  ğŸ‘¼ 
ğŸ‘¯  ğŸ’†  ğŸ’‡  ğŸ‘°  ğŸ™  ğŸ™  ğŸ™…  ğŸ™†  ğŸ’  ğŸ™‹  ğŸ™‡
fitz-optional	â˜º  â˜¹  ğŸ™  ğŸ™‚  ğŸ˜€  ğŸ˜  ğŸ˜‚  ğŸ˜ƒ  ğŸ˜„  ğŸ˜…  ğŸ˜†  ğŸ˜‰  ğŸ˜Š  ğŸ˜‹  ğŸ˜Œ  ğŸ˜ 
ğŸ˜  ğŸ˜  ğŸ˜  ğŸ˜‘  ğŸ˜’  ğŸ˜“  ğŸ˜”  ğŸ˜•  ğŸ˜–  ğŸ˜—  ğŸ˜˜  ğŸ˜™  ğŸ˜š  ğŸ˜›  ğŸ˜œ  ğŸ˜ 
ğŸ˜  ğŸ˜Ÿ  ğŸ˜   ğŸ˜¡  ğŸ˜¢  ğŸ˜£  ğŸ˜¤  ğŸ˜¥  ğŸ˜¦  ğŸ˜§  ğŸ˜¨  ğŸ˜©  ğŸ˜ª  ğŸ˜«  ğŸ˜¬  ğŸ˜­ 
ğŸ˜®  ğŸ˜¯  ğŸ˜°  ğŸ˜±  ğŸ˜²  ğŸ˜³  ğŸ˜´  ğŸ˜µ  ğŸ˜¶  ğŸ˜·  ğŸ˜‡  ğŸ˜ˆ  ğŸ‘¿  ğŸ™Œ  ğŸ™  ğŸš¶ 
ğŸƒ  ğŸ’ƒ  ğŸ‘ˆ  ğŸ‘‰  â˜  ğŸ‘†  ğŸ–•  ğŸ‘‡  âœŒ  ğŸ––  âœŠ  âœ‹  ğŸ‘Š  ğŸ‘‹  ğŸ‘Œ  ğŸ‘ 
ğŸ‘  ğŸ‘  ğŸ‘  âœ  ğŸ–  ğŸ’…  ğŸ’ª  ğŸ‘€  ğŸ‘  ğŸ‘‚  ğŸ‘ƒ  ğŸ‘…  ğŸ’‹  ğŸ‘„  ğŸš´  ğŸšµ 
ğŸš£  ğŸ›€  ğŸ‚  ğŸ„  ğŸ‡  ğŸŠ
flag	â›³  ğŸŒ  ğŸ  ğŸ“«  ğŸ“ª  ğŸ“¬  ğŸ“­  ğŸ  ğŸ³  ğŸ´  ğŸš©  ğŸ‡¦ğŸ‡«  ğŸ‡¦ğŸ‡½  ğŸ‡¦ğŸ‡±  ğŸ‡©ğŸ‡¿  ğŸ‡¦ğŸ‡¸ 
ğŸ‡¦ğŸ‡©  ğŸ‡¦ğŸ‡´  ğŸ‡¦ğŸ‡®  ğŸ‡¦ğŸ‡¶  ğŸ‡¦ğŸ‡¬  ğŸ‡¦ğŸ‡·  ğŸ‡¦ğŸ‡²  ğŸ‡¦ğŸ‡¼  ğŸ‡¦ğŸ‡¨  ğŸ‡¦ğŸ‡º  ğŸ‡¦ğŸ‡¹  ğŸ‡¦ğŸ‡¿  ğŸ‡§ğŸ‡¸  ğŸ‡§ğŸ‡­  ğŸ‡§ğŸ‡©  ğŸ‡§ğŸ‡§ 
ğŸ‡§ğŸ‡¾  ğŸ‡§ğŸ‡ª  ğŸ‡§ğŸ‡¿  ğŸ‡§ğŸ‡¯  ğŸ‡§ğŸ‡²  ğŸ‡§ğŸ‡¹  ğŸ‡§ğŸ‡´  ğŸ‡§ğŸ‡¦  ğŸ‡§ğŸ‡¼  ğŸ‡§ğŸ‡»  ğŸ‡§ğŸ‡·  ğŸ‡®ğŸ‡´  ğŸ‡»ğŸ‡¬  ğŸ‡§ğŸ‡³  ğŸ‡§ğŸ‡¬  ğŸ‡§ğŸ‡« 
ğŸ‡§ğŸ‡®  ğŸ‡°ğŸ‡­  ğŸ‡¨ğŸ‡²  ğŸ‡¨ğŸ‡¦  ğŸ‡®ğŸ‡¨  ğŸ‡¨ğŸ‡»  ğŸ‡§ğŸ‡¶  ğŸ‡°ğŸ‡¾  ğŸ‡¨ğŸ‡«  ğŸ‡ªğŸ‡¦  ğŸ‡¹ğŸ‡©  ğŸ‡¨ğŸ‡±  ğŸ‡¨ğŸ‡³  ğŸ‡¨ğŸ‡½  ğŸ‡¨ğŸ‡µ  ğŸ‡¨ğŸ‡¨ 
ğŸ‡¨ğŸ‡´  ğŸ‡°ğŸ‡²  ğŸ‡¨ğŸ‡¬  ğŸ‡¨ğŸ‡©  ğŸ‡¨ğŸ‡°  ğŸ‡¨ğŸ‡·  ğŸ‡¨ğŸ‡®  ğŸ‡­ğŸ‡·  ğŸ‡¨ğŸ‡º  ğŸ‡¨ğŸ‡¼  ğŸ‡¨ğŸ‡¾  ğŸ‡¨ğŸ‡¿  ğŸ‡©ğŸ‡°  ğŸ‡©ğŸ‡¬  ğŸ‡©ğŸ‡¯  ğŸ‡©ğŸ‡² 
ğŸ‡©ğŸ‡´  ğŸ‡ªğŸ‡¨  ğŸ‡ªğŸ‡¬  ğŸ‡¸ğŸ‡»  ğŸ‡¬ğŸ‡¶  ğŸ‡ªğŸ‡·  ğŸ‡ªğŸ‡ª  ğŸ‡ªğŸ‡¹  ğŸ‡ªğŸ‡º  ğŸ‡«ğŸ‡°  ğŸ‡«ğŸ‡´  ğŸ‡«ğŸ‡¯  ğŸ‡«ğŸ‡®  ğŸ‡«ğŸ‡·  ğŸ‡¬ğŸ‡«  ğŸ‡µğŸ‡« 
ğŸ‡¹ğŸ‡«  ğŸ‡¬ğŸ‡¦  ğŸ‡¬ğŸ‡²  ğŸ‡¬ğŸ‡ª  ğŸ‡©ğŸ‡ª  ğŸ‡¬ğŸ‡­  ğŸ‡¬ğŸ‡®  ğŸ‡¬ğŸ‡·  ğŸ‡¬ğŸ‡±  ğŸ‡¬ğŸ‡©  ğŸ‡¬ğŸ‡µ  ğŸ‡¬ğŸ‡º  ğŸ‡¬ğŸ‡¹  ğŸ‡¬ğŸ‡¬  ğŸ‡¬ğŸ‡³  ğŸ‡¬ğŸ‡¼ 
ğŸ‡¬ğŸ‡¾  ğŸ‡­ğŸ‡¹  ğŸ‡­ğŸ‡²  ğŸ‡­ğŸ‡³  ğŸ‡­ğŸ‡°  ğŸ‡­ğŸ‡º  ğŸ‡®ğŸ‡¸  ğŸ‡®ğŸ‡³  ğŸ‡®ğŸ‡©  ğŸ‡®ğŸ‡·  ğŸ‡®ğŸ‡¶  ğŸ‡®ğŸ‡ª  ğŸ‡®ğŸ‡²  ğŸ‡®ğŸ‡±  ğŸ‡®ğŸ‡¹  ğŸ‡¯ğŸ‡² 
ğŸ‡¯ğŸ‡µ  ğŸ‡¯ğŸ‡ª  ğŸ‡¯ğŸ‡´  ğŸ‡°ğŸ‡¿  ğŸ‡°ğŸ‡ª  ğŸ‡°ğŸ‡®  ğŸ‡½ğŸ‡°  ğŸ‡°ğŸ‡¼  ğŸ‡°ğŸ‡¬  ğŸ‡±ğŸ‡¦  ğŸ‡±ğŸ‡»  ğŸ‡±ğŸ‡§  ğŸ‡±ğŸ‡¸  ğŸ‡±ğŸ‡·  ğŸ‡±ğŸ‡¾  ğŸ‡±ğŸ‡® 
ğŸ‡±ğŸ‡¹  ğŸ‡±ğŸ‡º  ğŸ‡²ğŸ‡´  ğŸ‡²ğŸ‡°  ğŸ‡²ğŸ‡¬  ğŸ‡²ğŸ‡¼  ğŸ‡²ğŸ‡¾  ğŸ‡²ğŸ‡»  ğŸ‡²ğŸ‡±  ğŸ‡²ğŸ‡¹  ğŸ‡²ğŸ‡­  ğŸ‡²ğŸ‡¶  ğŸ‡²ğŸ‡·  ğŸ‡²ğŸ‡º  ğŸ‡¾ğŸ‡¹  ğŸ‡²ğŸ‡½ 
ğŸ‡«ğŸ‡²  ğŸ‡²ğŸ‡©  ğŸ‡²ğŸ‡¨  ğŸ‡²ğŸ‡³  ğŸ‡²ğŸ‡ª  ğŸ‡²ğŸ‡¸  ğŸ‡²ğŸ‡¦  ğŸ‡²ğŸ‡¿  ğŸ‡²ğŸ‡²  ğŸ‡³ğŸ‡¦  ğŸ‡³ğŸ‡·  ğŸ‡³ğŸ‡µ  ğŸ‡³ğŸ‡±  ğŸ‡³ğŸ‡¨  ğŸ‡³ğŸ‡¿  ğŸ‡³ğŸ‡® 
ğŸ‡³ğŸ‡ª  ğŸ‡³ğŸ‡¬  ğŸ‡³ğŸ‡º  ğŸ‡³ğŸ‡«  ğŸ‡²ğŸ‡µ  ğŸ‡°ğŸ‡µ  ğŸ‡³ğŸ‡´  ğŸ‡´ğŸ‡²  ğŸ‡µğŸ‡°  ğŸ‡µğŸ‡¼  ğŸ‡µğŸ‡¸  ğŸ‡µğŸ‡¦  ğŸ‡µğŸ‡¬  ğŸ‡µğŸ‡¾  ğŸ‡µğŸ‡ª  ğŸ‡µğŸ‡­ 
ğŸ‡µğŸ‡³  ğŸ‡µğŸ‡±  ğŸ‡µğŸ‡¹  ğŸ‡µğŸ‡·  ğŸ‡¶ğŸ‡¦  ğŸ‡·ğŸ‡ª  ğŸ‡·ğŸ‡´  ğŸ‡·ğŸ‡º  ğŸ‡·ğŸ‡¼  ğŸ‡¼ğŸ‡¸  ğŸ‡¸ğŸ‡²  ğŸ‡¸ğŸ‡¹  ğŸ‡¸ğŸ‡¦  ğŸ‡¸ğŸ‡³  ğŸ‡·ğŸ‡¸  ğŸ‡¸ğŸ‡¨ 
ğŸ‡¸ğŸ‡±  ğŸ‡¸ğŸ‡¬  ğŸ‡¸ğŸ‡½  ğŸ‡¸ğŸ‡°  ğŸ‡¸ğŸ‡®  ğŸ‡¸ğŸ‡§  ğŸ‡¸ğŸ‡´  ğŸ‡¿ğŸ‡¦  ğŸ‡¬ğŸ‡¸  ğŸ‡°ğŸ‡·  ğŸ‡¸ğŸ‡¸  ğŸ‡ªğŸ‡¸  ğŸ‡±ğŸ‡°  ğŸ‡§ğŸ‡±  ğŸ‡¸ğŸ‡­  ğŸ‡°ğŸ‡³ 
ğŸ‡±ğŸ‡¨  ğŸ‡²ğŸ‡«  ğŸ‡µğŸ‡²  ğŸ‡»ğŸ‡¨  ğŸ‡¸ğŸ‡©  ğŸ‡¸ğŸ‡·  ğŸ‡¸ğŸ‡¯  ğŸ‡¸ğŸ‡¿  ğŸ‡¸ğŸ‡ª  ğŸ‡¨ğŸ‡­  ğŸ‡¸ğŸ‡¾  ğŸ‡¹ğŸ‡¼  ğŸ‡¹ğŸ‡¯  ğŸ‡¹ğŸ‡¿  ğŸ‡¹ğŸ‡­  ğŸ‡¹ğŸ‡± 
ğŸ‡¹ğŸ‡¬  ğŸ‡¹ğŸ‡°  ğŸ‡¹ğŸ‡´  ğŸ‡¹ğŸ‡¹  ğŸ‡¹ğŸ‡¦  ğŸ‡¹ğŸ‡³  ğŸ‡¹ğŸ‡·  ğŸ‡¹ğŸ‡²  ğŸ‡¹ğŸ‡¨  ğŸ‡¹ğŸ‡»  ğŸ‡ºğŸ‡¬  ğŸ‡ºğŸ‡¦  ğŸ‡¦ğŸ‡ª  ğŸ‡¬ğŸ‡§  ğŸ‡ºğŸ‡¸  ğŸ‡ºğŸ‡¾ 
ğŸ‡ºğŸ‡²  ğŸ‡»ğŸ‡®  ğŸ‡ºğŸ‡¿  ğŸ‡»ğŸ‡º  ğŸ‡»ğŸ‡¦  ğŸ‡»ğŸ‡ª  ğŸ‡»ğŸ‡³  ğŸ‡¼ğŸ‡«  ğŸ‡ªğŸ‡­  ğŸ‡¾ğŸ‡ª  ğŸ‡¿ğŸ‡²  ğŸ‡¿ğŸ‡¼
flame	ğŸ”¥
flash	ğŸ“¸
flashlight, torch	ğŸ”¦
fleur-de-lis	âšœ
flower	ğŸ’  ğŸŒ¸  ğŸ’®  ğŸŒ¹  ğŸŒº  ğŸŒ»  ğŸŒ¼  ğŸŒ·  ğŸ´
flutter	ğŸƒ
fly	ğŸ•Š  ğŸ’¸
fog	ğŸŒ  ğŸŒ«
folder	ğŸ“  ğŸ“‚
food	ğŸ˜‹  ğŸ‡  ğŸˆ  ğŸ‰  ğŸŠ  ğŸ‹  ğŸŒ  ğŸ  ğŸ  ğŸ  ğŸ  ğŸ‘  ğŸ’  ğŸ“  ğŸ…  ğŸ† 
ğŸŒ¶  ğŸ  ğŸ–  ğŸ—  ğŸ”  ğŸŸ  ğŸ•  ğŸ²  ğŸ±  ğŸ˜  ğŸ™  ğŸš  ğŸ›  ğŸœ  ğŸ  ğŸ  
ğŸ¢  ğŸ£  ğŸ¤  ğŸ¥  ğŸ¡  ğŸ¦  ğŸ§  ğŸ¨  ğŸ©  ğŸª  ğŸ‚  ğŸ°  ğŸ«  ğŸ¬  ğŸ­  ğŸ® 
ğŸ¯  â˜•  ğŸµ  ğŸ¶  ğŸ·  ğŸ¸  ğŸ¹  ğŸº  ğŸ»  ğŸ¼  ğŸ½  ğŸ´  ğŸ³
football	ğŸˆ  ğŸ‰
footprint	ğŸ‘£
forbidden, no, not, prohibited	ğŸ™…  ğŸ™ˆ  ğŸ™‰  ğŸ™Š  ğŸš³  ğŸš«  ğŸš­  ğŸš¯  ğŸš±  ğŸš·  â›”  ğŸ”•  ğŸ“µ  ğŸ”
fork	ğŸ½  ğŸ´
fortune	ğŸ”®  ğŸ”¯
fountain	â›²  ğŸ–‹
frame, picture	ğŸ–¼
frames	ğŸ
france	ğŸ‡«ğŸ‡·
free	ğŸ†“
french	ğŸŸ  ğŸ‡¬ğŸ‡«  ğŸ‡µğŸ‡«  ğŸ‡¹ğŸ‡«  ğŸ‡²ğŸ‡«
fried, prawn, shrimp, tempura	ğŸ¤
fries	ğŸŸ
frog	ğŸ¸
frown	â˜¹  ğŸ™  ğŸ˜¦  ğŸ™
fruit	ğŸ‡  ğŸˆ  ğŸ‰  ğŸŠ  ğŸ‹  ğŸŒ  ğŸ  ğŸ  ğŸ  ğŸ  ğŸ‘  ğŸ’  ğŸ“
fuel, fuelpump, gas, pump	â›½
fuji	ğŸ—»
full	ğŸŒ•  ğŸŒ  ğŸ’¯
funeral, urn	âš±
futuna, wallis	ğŸ‡¼ğŸ‡«
gabon	ğŸ‡¬ğŸ‡¦
gambia	ğŸ‡¬ğŸ‡²
game	ğŸ°  ğŸ²  â™   â™¥  â™¦  â™£  ğŸƒ  ğŸ€„  ğŸ®  ğŸ•¹  ğŸ±  ğŸ³  ğŸ¯  ğŸ´
garden	ğŸ¡
gear	âš™
gem, jewel	ğŸ’
gemini	â™Š
geometric	â–ª  â–«  â—»  â—¼  â—½  â—¾  â¬›  â¬œ  ğŸ”¶  ğŸ”·  ğŸ”¸  ğŸ”¹  ğŸ”º  ğŸ”»  ğŸ’   ğŸ”˜ 
ğŸ”²  ğŸ”³  âšª  âš«  ğŸ”´  ğŸ”µ
georgia	ğŸ‡¬ğŸ‡ª  ğŸ‡¬ğŸ‡¸
germany	ğŸ‡©ğŸ‡ª
gesture	ğŸ™  ğŸ™  ğŸ™…  ğŸ™†  ğŸ™‹  ğŸ™‡  ğŸ™Œ  ğŸ™  ğŸ™ˆ  ğŸ™‰  ğŸ™Š
ghana	ğŸ‡¬ğŸ‡­
ghost	ğŸ‘»
gibbous	ğŸŒ”  ğŸŒ–
gibraltar	ğŸ‡¬ğŸ‡®
gift, present, wrapped	ğŸ
girl	ğŸ‘§  ğŸ‘¯
glass	ğŸ·  ğŸ¸  ğŸ”  ğŸ”
glittery, glow, shining	ğŸŒŸ
goat	ğŸ
goblin	ğŸ‘º
golf	â›³  ğŸŒ
grape	ğŸ‡
greece	ğŸ‡¬ğŸ‡·
green	ğŸ’š  ğŸ  ğŸ“—  ğŸ”°
greenland	ğŸ‡¬ğŸ‡±
grenada	ğŸ‡¬ğŸ‡©
grenadines, vincent	ğŸ‡»ğŸ‡¨
grimace	ğŸ˜¬
grin	ğŸ˜€  ğŸ˜  ğŸ˜¸
growing, heartpulse, nervous	ğŸ’—
growth, upward	ğŸ’¹  ğŸ“ˆ
gua pi mao	ğŸ‘²
guadeloupe	ğŸ‡¬ğŸ‡µ
guam	ğŸ‡¬ğŸ‡º
guard, guardsman	ğŸ’‚
guatemala	ğŸ‡¬ğŸ‡¹
guernsey	ğŸ‡¬ğŸ‡¬
guiana	ğŸ‡¬ğŸ‡«
guinea	ğŸ‡¬ğŸ‡¶  ğŸ‡¬ğŸ‡³  ğŸ‡¬ğŸ‡¼  ğŸ‡µğŸ‡¬
guitar	ğŸ¸
gun, pistol, revolver	ğŸ”«
guyana	ğŸ‡¬ğŸ‡¾
haiti	ğŸ‡­ğŸ‡¹
halloween, jack	ğŸƒ
halo, innocent	ğŸ˜‡
hammer	ğŸ”¨  âš’  ğŸ› 
hamster	ğŸ¹
hand	ğŸ™‹  ğŸ™Œ  ğŸ™  ğŸ‘«  ğŸ‘¬  ğŸ‘­  ğŸ‘ˆ  ğŸ‘‰  â˜  ğŸ‘†  ğŸ–•  ğŸ‘‡  âœŒ  ğŸ––  âœŠ  âœ‹ 
ğŸ‘Š  ğŸ‘‹  ğŸ‘Œ  ğŸ‘  ğŸ‘  ğŸ‘  ğŸ‘  âœ  ğŸ–
handbag	ğŸ‘œ
happy	ğŸ™‹
hash	#âƒ£
hat	ğŸ‘²  ğŸ‘·  ğŸ‘’  ğŸ©  â›‘  ğŸ“
hatching	ğŸ£
head, speaking	ğŸ—£
hear	ğŸ™‰
heard, mcdonald	ğŸ‡­ğŸ‡²
heart	ğŸ˜  ğŸ˜˜  ğŸ’‘  ğŸ’‹  ğŸ’˜  â¤  ğŸ’“  ğŸ’”  ğŸ’•  ğŸ’–  ğŸ’—  ğŸ’™  ğŸ’š  ğŸ’›  ğŸ’œ  ğŸ’ 
ğŸ’  ğŸ’Ÿ  â£  ğŸ’Œ  ğŸ˜»  â™¥
hearts	â™¥
heel	ğŸ‘ 
helena	ğŸ‡¸ğŸ‡­
helicopter	ğŸš
helm	âˆ
help	ğŸ’  ğŸ†˜
herb	ğŸŒ¿
hibiscus	ğŸŒº
high	ğŸ”Š
highway, motorway, road	ğŸ›£
hike, walk, walking	ğŸš¶
hindu, om	ğŸ•‰
hocho	ğŸ”ª
hold	ğŸ‘«  ğŸ‘¬  ğŸ‘­
hole	ğŸ•³  â›³
holy, vatican	ğŸ‡»ğŸ‡¦
home	ğŸ   ğŸ¡
honduras	ğŸ‡­ğŸ‡³
honey, honeypot	ğŸ¯
hong kong	ğŸ‡­ğŸ‡°
hooray	ğŸ™Œ
horn, postal	ğŸ“¯
horns	ğŸ˜ˆ
horrible, taste	ğŸ˜
horse	ğŸ´  ğŸ  ğŸ   ğŸ‡
hospital	ğŸ¥
hot	ğŸŒ¶  â˜•  â™¨
hotel	ğŸ¨  ğŸ©  ğŸ›  ğŸ›Œ  ğŸ›  ğŸ›‹  ğŸ›
hotsprings, springs	â™¨
hourglass, sand	âŒ›  â³
house	ğŸ˜  ğŸš  ğŸ   ğŸ¡
people	â˜º  â˜¹  ğŸ™  ğŸ™‚  ğŸ˜€  ğŸ˜  ğŸ˜‚  ğŸ˜ƒ  ğŸ˜„  ğŸ˜…  ğŸ˜†  ğŸ˜‰  ğŸ˜Š  ğŸ˜‹  ğŸ˜Œ  ğŸ˜ 
ğŸ˜  ğŸ˜  ğŸ˜  ğŸ˜‘  ğŸ˜’  ğŸ˜“  ğŸ˜”  ğŸ˜•  ğŸ˜–  ğŸ˜—  ğŸ˜˜  ğŸ˜™  ğŸ˜š  ğŸ˜›  ğŸ˜œ  ğŸ˜ 
ğŸ˜  ğŸ˜Ÿ  ğŸ˜   ğŸ˜¡  ğŸ˜¢  ğŸ˜£  ğŸ˜¤  ğŸ˜¥  ğŸ˜¦  ğŸ˜§  ğŸ˜¨  ğŸ˜©  ğŸ˜ª  ğŸ˜«  ğŸ˜¬  ğŸ˜­ 
ğŸ˜®  ğŸ˜¯  ğŸ˜°  ğŸ˜±  ğŸ˜²  ğŸ˜³  ğŸ˜´  ğŸ˜µ  ğŸ˜¶  ğŸ˜·  ğŸ˜‡  ğŸ˜ˆ  ğŸ‘¿  ğŸ‘¦  ğŸ‘§  ğŸ‘¨ 
ğŸ‘©  ğŸ‘´  ğŸ‘µ  ğŸ‘¶  ğŸ‘±  ğŸ‘®  ğŸ‘²  ğŸ‘³  ğŸ‘·  ğŸ‘¸  ğŸ’‚  ğŸ…  ğŸ‘¼  ğŸ•µ  ğŸ‘¯  ğŸ’† 
ğŸ’‡  ğŸ‘°  ğŸ™  ğŸ™  ğŸ™…  ğŸ™†  ğŸ’  ğŸ™‹  ğŸ™‡  ğŸ™Œ  ğŸ™  ğŸ—£  ğŸ‘¤  ğŸ‘¥  ğŸš¶  ğŸƒ 
ğŸ’ƒ  ğŸ•´  ğŸ’  ğŸ’‘  ğŸ‘ª  ğŸ‘«  ğŸ‘¬  ğŸ‘­  ğŸ‘ˆ  ğŸ‘‰  â˜  ğŸ‘†  ğŸ–•  ğŸ‘‡  âœŒ  ğŸ–– 
âœŠ  âœ‹  ğŸ‘Š  ğŸ‘‹  ğŸ‘Œ  ğŸ‘  ğŸ‘  ğŸ‘  ğŸ‘  âœ  ğŸ–  ğŸ’…  ğŸ’ª  ğŸ‘£  ğŸ‘€  ğŸ‘ 
ğŸ‘‚  ğŸ‘ƒ  ğŸ‘…  ğŸ’‹  ğŸ‘„  ğŸš´  ğŸšµ  ğŸ 
ğŸŒ  â›·  ğŸ‚  ğŸ„  ğŸ‡  ğŸŠ  â›¹  ğŸ‹
 â˜ â›‘
ğŸ’€ ğŸ’˜ â¤ ğŸ’“ ğŸ’” ğŸ’• ğŸ’– ğŸ’— ğŸ’™ ğŸ’š ğŸ’› ğŸ’œ ğŸ’ ğŸ’ ğŸ’Ÿ ğŸ’Œ ğŸ’§ ğŸ’¤ ğŸ’¢ ğŸ’¥ ğŸ’¦ ğŸ’¨ ğŸ’« ğŸ’¬ ğŸ’­ ğŸ‘“ ğŸ‘” ğŸ‘• ğŸ‘– ğŸ‘— ğŸ‘˜ ğŸ‘™ ğŸ‘š ğŸ‘› ğŸ‘œ ğŸ‘ ğŸ‘ ğŸ‘Ÿ ğŸ‘  ğŸ‘¡ ğŸ‘¢ ğŸ‘‘ ğŸ‘’ ğŸ© ğŸ‘¹ ğŸ‘º ğŸ‘» ğŸ‘½ ğŸ‘¾ ğŸŒ‚ ğŸŒŸ ğŸ½ ğŸ”¥ âœ¨ ğŸ€ ğŸ’¼ ğŸ’„ ğŸ’ ğŸ’
hungary	ğŸ‡­ğŸ‡º
hushed, stunned	ğŸ˜¯
i	â„¹
ice	ğŸ¦  ğŸ§  ğŸ¨  â›¸
icecream, soft	ğŸ¦
iceland	ğŸ‡®ğŸ‡¸
id, identity	ğŸ†”
ideograph	ãŠ—  ãŠ™
inbox	ğŸ“¥
incoming	ğŸ“¨
index	ğŸ‘ˆ  ğŸ‘‰  â˜  ğŸ‘†  ğŸ‘‡  ğŸ—‚  ğŸ“‡
india	ğŸ‡®ğŸ‡³
indian	ğŸ‡®ğŸ‡´
indonesia	ğŸ‡®ğŸ‡©
information	ğŸ’  â„¹
ink, privacy	ğŸ”
input	ğŸ”   ğŸ”¡  ğŸ”¢  ğŸ”£  ğŸ”¤
insect	ğŸ›  ğŸœ  ğŸ  ğŸ  ğŸ•·
inside	ğŸ’ 
instrument	ğŸ·  ğŸ¸  ğŸ¹  ğŸº  ğŸ»
intercardinal	â†—  â†˜  â†™  â†–
interrobang	â‰
mobile, cell, phone	ğŸ“±
iran	ğŸ‡®ğŸ‡·
iraq	ğŸ‡®ğŸ‡¶
ireland	ğŸ‡®ğŸ‡ª  ğŸ‡¬ğŸ‡§
ironic, wry	ğŸ˜¼
islam, muslim	â˜ª
island	ğŸ  ğŸ‡¦ğŸ‡¨  ğŸ‡§ğŸ‡»  ğŸ‡¨ğŸ‡½  ğŸ‡¨ğŸ‡µ  ğŸ‡­ğŸ‡²  ğŸ‡³ğŸ‡«
islands	ğŸ‡¦ğŸ‡½  ğŸ‡»ğŸ‡¬  ğŸ‡®ğŸ‡¨  ğŸ‡°ğŸ‡¾  ğŸ‡¨ğŸ‡¨  ğŸ‡¨ğŸ‡°  ğŸ‡«ğŸ‡°  ğŸ‡«ğŸ‡´  ğŸ‡¬ğŸ‡¬  ğŸ‡­ğŸ‡²  ğŸ‡²ğŸ‡­  ğŸ‡²ğŸ‡µ  ğŸ‡µğŸ‡³  ğŸ‡¸ğŸ‡§  ğŸ‡¬ğŸ‡¸  ğŸ‡¸ğŸ‡¯ 
ğŸ‡¹ğŸ‡¨  ğŸ‡ºğŸ‡²  ğŸ‡»ğŸ‡®  ğŸ‡¼ğŸ‡«
isle	ğŸ‡®ğŸ‡²
israel	ğŸ‡®ğŸ‡±
italy	ğŸ‡®ğŸ‡¹
jamaica	ğŸ‡¯ğŸ‡²
jan, mayen, svalbard	ğŸ‡¸ğŸ‡¯
japan	ğŸ—¾  ğŸ‡¯ğŸ‡µ
japanese	ğŸ‘¹  ğŸ‘º  ğŸ™  ğŸ¡  ğŸ£  ğŸ¯  ğŸ®  ğŸ‹  ğŸŒ  ğŸ  ğŸ  ğŸ´  ğŸ”°  ğŸˆ  ğŸˆ‚  ğŸˆ¹ 
ğŸ‰  ğŸˆ¯  ğŸˆ·  ğŸˆ¶  ğŸˆš  ğŸˆ²
jeans, pants, trousers	ğŸ‘–
jersey	ğŸ‡¯ğŸ‡ª
jockey	ğŸ‡
joke	ğŸ˜œ
joker	ğŸƒ
jordan	ğŸ‡¯ğŸ‡´
joy	ğŸ˜‚  ğŸ˜¹
joystick	ğŸ•¹
karaoke	ğŸ¤
kazakhstan	ğŸ‡°ğŸ‡¿
kebab, oden, seafood	ğŸ¢
kenya	ğŸ‡°ğŸ‡ª
key	ğŸ”  ğŸ”‘  ğŸ—
keyboard	ğŸ¹  âŒ¨
keycap	#âƒ£  *âƒ£  0âƒ£  1âƒ£  2âƒ£  3âƒ£  4âƒ£  5âƒ£  6âƒ£  7âƒ£  8âƒ£  9âƒ£  ğŸ”Ÿ
kimono	ğŸ‘˜
kinshasa	ğŸ‡¨ğŸ‡©
kiribati	ğŸ‡°ğŸ‡®
kiss	ğŸ˜—  ğŸ˜˜  ğŸ˜™  ğŸ˜š  ğŸ’  ğŸ’‹  ğŸ˜½
kitts, nevis	ğŸ‡°ğŸ‡³
knife	ğŸ½  ğŸ´  ğŸ—¡  ğŸ”ª
knobs	ğŸ›
koala	ğŸ¨
korea	ğŸ‡°ğŸ‡µ  ğŸ‡°ğŸ‡·
kosovo	ğŸ‡½ğŸ‡°
kuwait	ğŸ‡°ğŸ‡¼
kyrgyz, kyrgyzstan	ğŸ‡°ğŸ‡¬
label	ğŸ·
lanka, sri	ğŸ‡±ğŸ‡°
lantern	ğŸ®  ğŸƒ
lao, laos	ğŸ‡±ğŸ‡¦
latin, letters	ğŸ”   ğŸ”¡  ğŸ”¤
latvia	ğŸ‡±ğŸ‡»
laugh, satisfied	ğŸ˜†
lavatory, restroom, wc	ğŸš¹  ğŸšº  ğŸš»  ğŸš¾
leaf	ğŸŒ¿  ğŸ€  ğŸ  ğŸ‚  ğŸƒ  ğŸ”°
lebanon	ğŸ‡±ğŸ‡§
ledger	ğŸ“’
left, reverse	â—€
left luggage, locker, luggage	ğŸ›…
leg, poultry	ğŸ—
leo	â™Œ
leopard	ğŸ†
lesotho	ğŸ‡±ğŸ‡¸
leste, timor	ğŸ‡¹ğŸ‡±
letter	ğŸ’Œ  ğŸ“§  ğŸ“¨  ğŸ“©  ğŸ“¤  ğŸ“¥
level, slider	ğŸš
liberia	ğŸ‡±ğŸ‡·
liberty	ğŸ—½
libra	â™
libya, libyan	ğŸ‡±ğŸ‡¾
liechtenstein	ğŸ‡±ğŸ‡®
lifter	ğŸ‹
light	ğŸš¨  ğŸš¥  ğŸš¦  ğŸ•¯  ğŸ’¡  ğŸ”¦  ğŸ®
lightning	ğŸŒ©  âš¡
link	ğŸ–‡  ğŸ”—
lips	ğŸ’‹  ğŸ‘„
lipstick, makeup	ğŸ’„
lithuania	ğŸ‡±ğŸ‡¹
litter	ğŸš®  ğŸš¯
litterbox	ğŸš®
lock	ğŸ”’  ğŸ”“  ğŸ”  ğŸ”  ğŸ”‘  ğŸ—
locomotive, steam	ğŸš‚
lollipop	ğŸ­
loop	â°  â¿
lorry, semi	ğŸš›
loud	ğŸ”Š  ğŸ“¢
loudspeaker, public address	ğŸ“¢
love	ğŸ˜  ğŸ’‘  ğŸ’•  ğŸ’Œ  ğŸ˜»  ğŸ©
low	ğŸ”‰  ğŸ”…
lowered	ğŸ“ª  ğŸ“­
lucia	ğŸ‡±ğŸ‡¨
luxembourg	ğŸ‡±ğŸ‡º
m	â“‚
macao, macau	ğŸ‡²ğŸ‡´
macedonia	ğŸ‡²ğŸ‡°
madagascar	ğŸ‡²ğŸ‡¬
magnifying, search	ğŸ”  ğŸ”
mahjong	ğŸ€„
mail	ğŸ’Œ  ğŸ“§  ğŸ“¨  ğŸ“©  ğŸ“¤  ğŸ“¥  ğŸ“«  ğŸ“ª  ğŸ“¬  ğŸ“­  ğŸ“®
mailbox, postbox	ğŸ“«  ğŸ“ª  ğŸ“¬  ğŸ“­  ğŸ“®
malawi	ğŸ‡²ğŸ‡¼
malaysia	ğŸ‡²ğŸ‡¾
maldives	ğŸ‡²ğŸ‡»
mali	ğŸ‡²ğŸ‡±
malta	ğŸ‡²ğŸ‡¹
man	ğŸ‘¨  ğŸ‘´  ğŸ‘²  ğŸ‘³  ğŸ•´  ğŸ‘«  ğŸ‘  ğŸ‡®ğŸ‡²
map	ğŸ—º  ğŸ—¾
maple	ğŸ
marathon, runner	ğŸƒ
mariana	ğŸ‡²ğŸ‡µ
mark	ğŸ’‹  â£  ğŸ“‘  ğŸ”–  ğŸ”›  âœ…  âœ”  âŒ  â  ã€½  â€¼  â‰  â“  â”  â•  â— 
â„¢  ğŸ†™
marker, tabs	ğŸ“‘
market, rise	ğŸ’¹
marshall	ğŸ‡²ğŸ‡­
martin	ğŸ‡²ğŸ‡«
martinique	ğŸ‡²ğŸ‡¶
mask	ğŸ˜·  ğŸ­
massage, salon	ğŸ’†
math	â•  â–  â—
mauritania	ğŸ‡²ğŸ‡·
mauritius	ğŸ‡²ğŸ‡º
mayotte	ğŸ‡¾ğŸ‡¹
meat	ğŸ–
medal	ğŸ…  ğŸ–
melon	ğŸˆ
memo	ğŸ“
men	ğŸ‘¬  ğŸš¹
menâ€™s	ğŸš¹
meridians	ğŸŒ
metro, subway	ğŸš‡
mexico	ğŸ‡²ğŸ‡½
mic, microphone	ğŸ™  ğŸ¤
micronesia	ğŸ‡«ğŸ‡²
microscope	ğŸ”¬
middle finger	ğŸ–•
military	ğŸ–
milk	ğŸ¼
milky way	ğŸŒŒ
minibus	ğŸš
minidisc	ğŸ’½
mining	â›
minus	â–
miquelon, pierre	ğŸ‡µğŸ‡²
mobile	ğŸ“±  ğŸ“³  ğŸ“´  ğŸ“²  ğŸ“µ  ğŸ“¶
mode, vibration	ğŸ“³
moldova	ğŸ‡²ğŸ‡©
monaco	ğŸ‡²ğŸ‡¨
money	ğŸ’°  ğŸ’´  ğŸ’µ  ğŸ’¶  ğŸ’·  ğŸ’¸  ğŸ’±  ğŸ’²  ğŸ’³  ğŸ’¹
moneybag	ğŸ’°
mongolia	ğŸ‡²ğŸ‡³
monkey	ğŸµ  ğŸ™ˆ  ğŸ™‰  ğŸ™Š  ğŸ’
monorail	ğŸš
monster	ğŸ‘¾
montenegro	ğŸ‡²ğŸ‡ª
montserrat	ğŸ‡²ğŸ‡¸
moon	ğŸŒ‘  ğŸŒ’  ğŸŒ“  ğŸŒ”  ğŸŒ•  ğŸŒ–  ğŸŒ—  ğŸŒ˜  ğŸŒ™  ğŸŒš  ğŸŒ›  ğŸŒœ  ğŸŒ  ğŸ‘
morning, sunrise	ğŸŒ„  ğŸŒ…
morocco	ğŸ‡²ğŸ‡¦
motorboat	ğŸ›¥
motorcycle	ğŸ
mountain	ğŸ”  â›°  ğŸŒ‹  ğŸ—»  ğŸŒ„  ğŸš  ğŸšµ  ğŸš 
mouse	ğŸ­  ğŸ  ğŸ–±
mouth	ğŸ˜ƒ  ğŸ˜„  ğŸ˜†  ğŸ˜¦  ğŸ˜®  ğŸ˜°  ğŸ˜¶  ğŸ‘„  ğŸ˜º
movie	ğŸ¥  ğŸ¦  ğŸ¬  ğŸ“½  ğŸ
moyai	ğŸ—¿
mozambique	ğŸ‡²ğŸ‡¿
munch, scream	ğŸ˜±
mushroom	ğŸ„
music	ğŸ¼  ğŸµ  ğŸ¶  ğŸ™  ğŸš  ğŸ›  ğŸ·  ğŸ¸  ğŸ¹  ğŸº  ğŸ»
mute	ğŸ”‡  ğŸ”•
nam, viet, vietnam	ğŸ‡»ğŸ‡³
namibia	ğŸ‡³ğŸ‡¦
national park, park	ğŸ
nature	ğŸµ  ğŸ’  ğŸ¶  ğŸ•  ğŸ©  ğŸº  ğŸ±  ğŸ˜¸  ğŸ˜¹  ğŸ˜º  ğŸ˜»  ğŸ˜¼  ğŸ˜½  ğŸ˜¾  ğŸ˜¿  ğŸ™€ 
ğŸˆ  ğŸ¯  ğŸ…  ğŸ†  ğŸ´  ğŸ  ğŸ®  ğŸ‚  ğŸƒ  ğŸ„  ğŸ·  ğŸ–  ğŸ—  ğŸ½  ğŸ  ğŸ‘ 
ğŸ  ğŸª  ğŸ«  ğŸ˜  ğŸ­  ğŸ  ğŸ€  ğŸ¹  ğŸ°  ğŸ‡  ğŸ¿  ğŸ»  ğŸ¨  ğŸ¼  ğŸ¾  ğŸ” 
ğŸ“  ğŸ£  ğŸ¤  ğŸ¥  ğŸ¦  ğŸ§  ğŸ•Š  ğŸ¸  ğŸŠ  ğŸ  ğŸ¢  ğŸ²  ğŸ‰  ğŸ³  ğŸ‹  ğŸ¬ 
ğŸŸ  ğŸ   ğŸ¡  ğŸ™  ğŸš  ğŸŒ  ğŸ›  ğŸœ  ğŸ  ğŸ  ğŸ’©  ğŸ‘½  ğŸ‘¾  ğŸ’  ğŸŒ¸  ğŸµ 
ğŸŒ¹  ğŸŒº  ğŸŒ»  ğŸŒ¼  ğŸŒ·  â¸™  â˜˜  ğŸŒ±  ğŸŒ²  ğŸŒ³  ğŸŒ´  ğŸŒµ  ğŸŒ¾  ğŸŒ¿  ğŸ€  ğŸ 
ğŸ‚  ğŸƒ  ğŸ‡  ğŸˆ  ğŸ‰  ğŸŠ  ğŸ‹  ğŸŒ  ğŸ  ğŸ  ğŸ  ğŸ  ğŸ‘  ğŸ’  ğŸ“  ğŸ… 
ğŸ†  ğŸŒ½  ğŸŒ¶  ğŸ„  ğŸŒ°  ğŸŒ  ğŸŒ  ğŸŒ  ğŸŒ  ğŸ”  ğŸŒ‹  ğŸ—»  ğŸ•  ğŸ–  ğŸœ  ğŸ 
ğŸ  ğŸŒ  ğŸŒ«  ğŸŒ   âš¡  â­
ğŸ™ˆ ğŸ™‰ ğŸ™Š
ğŸ’§ ğŸ ğŸ– ğŸ— ğŸ” ğŸŸ ğŸ• ğŸ² ğŸ± ğŸ˜ ğŸ™ ğŸš ğŸ› ğŸœ ğŸ ğŸ  ğŸ¢ ğŸ£ ğŸ¤ 
ğŸ¥ ğŸ¡ ğŸ¦ ğŸ§ ğŸ¨ ğŸ© ğŸª ğŸ° ğŸ« ğŸ¬ ğŸ­ ğŸ® ğŸ¯ â˜• ğŸµ ğŸ¶ ğŸ· ğŸ¸ 
ğŸ¹ ğŸº ğŸ» ğŸ¼ ğŸ´ ğŸ³ ğŸŒƒ ğŸŒ„ ğŸŒ… ğŸŒ† ğŸŒ‡ ğŸŒ‰ ğŸŒŠ ğŸŒŒ ğŸŒ‘ ğŸŒ’
 ğŸŒ“ ğŸŒ” ğŸŒ• ğŸŒ– ğŸŒ— ğŸŒ˜ ğŸŒ™ ğŸŒš ğŸŒ› ğŸŒœ â˜€ ğŸŒ ğŸŒ â˜ â›… ğŸŒ€ ğŸŒˆ ğŸŒ‚ â˜” â„ â›„ ğŸ‘
 ğŸŒ¡ â›ˆ ğŸŒ¤ ğŸŒ¥ ğŸŒ¦ ğŸŒ§ ğŸŒ¨ ğŸŒ© ğŸŒª ğŸŒ¬ â˜‚ â›± â˜ƒ  
nature-android	ğŸ’§  ğŸµ  ğŸ’  ğŸ¶  ğŸ•  ğŸ©  ğŸº  ğŸ±  ğŸˆ  ğŸ¯  ğŸ†  ğŸ´  ğŸ®  ğŸ‚  ğŸƒ  ğŸ„ 
ğŸ·  ğŸ–  ğŸ—  ğŸ½  ğŸ  ğŸ‘  ğŸ  ğŸª  ğŸ«  ğŸ˜  ğŸ­  ğŸ  ğŸ€  ğŸ¹  ğŸ°  ğŸ‡ 
ğŸ»  ğŸ¨  ğŸ¼  ğŸ¾  ğŸ”  ğŸ“  ğŸ£  ğŸ¤  ğŸ¥  ğŸ¦  ğŸ§  ğŸ¸  ğŸŠ  ğŸ  ğŸ¢  ğŸ² 
ğŸ‰  ğŸ³  ğŸ‹  ğŸ¬  ğŸŸ  ğŸ   ğŸ¡  ğŸ™  ğŸš  ğŸŒ  ğŸ›  ğŸœ  ğŸ  ğŸ  ğŸŒ¸  ğŸŒ¹ 
ğŸŒº  ğŸŒ»  ğŸŒ¼  ğŸŒ·  ğŸŒ±  ğŸŒ²  ğŸŒ³  ğŸŒ´  ğŸŒµ  ğŸŒ¾  ğŸŒ¿  ğŸ€  ğŸ  ğŸ‚  ğŸƒ  ğŸ‡ 
ğŸˆ  ğŸ‰  ğŸŠ  ğŸ‹  ğŸŒ  ğŸ  ğŸ  ğŸ  ğŸ  ğŸ‘  ğŸ’  ğŸ“  ğŸ…  ğŸ†  ğŸŒ½  ğŸ„ 
ğŸŒ°  ğŸ  ğŸ–  ğŸ—  ğŸ”  ğŸŸ  ğŸ•  ğŸ²  ğŸ±  ğŸ˜  ğŸ™  ğŸš  ğŸ›  ğŸœ  ğŸ  ğŸ  
ğŸ¢  ğŸ£  ğŸ¤  ğŸ¥  ğŸ¡  ğŸ¦  ğŸ§  ğŸ¨  ğŸ©  ğŸª  ğŸ°  ğŸ«  ğŸ¬  ğŸ­  ğŸ®  ğŸ¯ 
â˜•  ğŸµ  ğŸ¶  ğŸ·  ğŸ¸  ğŸ¹  ğŸº  ğŸ»  ğŸ¼  ğŸ´  ğŸ³  ğŸŒ  ğŸŒ  ğŸŒ  ğŸŒ  ğŸŒ‹ 
ğŸŒ  ğŸŒƒ  ğŸŒ„  ğŸŒ…  ğŸŒ†  ğŸŒ‡  ğŸŒ‰  ğŸŒŠ  ğŸŒŒ  ğŸŒ‘  ğŸŒ’  ğŸŒ“  ğŸŒ”  ğŸŒ•  ğŸŒ–  ğŸŒ— 
ğŸŒ˜  ğŸŒ™  ğŸŒš  ğŸŒ›  ğŸŒœ  â˜€  ğŸŒ  ğŸŒ  â˜  â›…  ğŸŒ€  ğŸŒˆ  ğŸŒ‚  â˜”  â„  â›„ 
ğŸ‘  âš¡
nature-apple	ğŸµ  ğŸ’  ğŸ¶  ğŸ•  ğŸ©  ğŸº  ğŸ±  ğŸˆ  ğŸ¯  ğŸ…  ğŸ†  ğŸ´  ğŸ  ğŸ®  ğŸ‚  ğŸƒ 
ğŸ„  ğŸ·  ğŸ–  ğŸ—  ğŸ½  ğŸ  ğŸ‘  ğŸ  ğŸª  ğŸ«  ğŸ˜  ğŸ­  ğŸ  ğŸ€  ğŸ¹  ğŸ° 
ğŸ‡  ğŸ»  ğŸ¨  ğŸ¼  ğŸ¾  ğŸ”  ğŸ“  ğŸ£  ğŸ¤  ğŸ¥  ğŸ¦  ğŸ§  ğŸ¸  ğŸŠ  ğŸ  ğŸ¢ 
ğŸ²  ğŸ‰  ğŸ³  ğŸ‹  ğŸ¬  ğŸŸ  ğŸ   ğŸ¡  ğŸ™  ğŸš  ğŸŒ  ğŸ›  ğŸœ  ğŸ  ğŸ  ğŸ’ 
ğŸŒ¸  ğŸŒ¹  ğŸŒº  ğŸŒ»  ğŸŒ¼  ğŸŒ·  ğŸŒ±  ğŸŒ²  ğŸŒ³  ğŸŒ´  ğŸŒµ  ğŸŒ¾  ğŸŒ¿  ğŸ€  ğŸ  ğŸ‚ 
ğŸƒ  ğŸ„  ğŸŒ°  ğŸŒ  ğŸŒ  ğŸŒ  ğŸŒ  ğŸŒ‹  ğŸŒ  ğŸŒŠ  ğŸŒŒ  ğŸŒ‘  ğŸŒ’  ğŸŒ“  ğŸŒ”  ğŸŒ• 
ğŸŒ–  ğŸŒ—  ğŸŒ˜  ğŸŒ™  ğŸŒš  ğŸŒ›  ğŸŒœ  â˜€  ğŸŒ  ğŸŒ  â˜  â›…  ğŸŒ€  ğŸŒˆ  â˜”  â„ 
â›„  ğŸŒ   âš¡  â­
nauru	ğŸ‡³ğŸ‡·
necktie	ğŸ‘”
needle, shot, syringe	ğŸ’‰
nepal	ğŸ‡³ğŸ‡µ
netherlands	ğŸ‡§ğŸ‡¶  ğŸ‡¨ğŸ‡¼  ğŸ‡³ğŸ‡±
new	ğŸ‡³ğŸ‡¨  ğŸ‡³ğŸ‡¿  ğŸ‡µğŸ‡¬  ğŸ†•
new caledonia	ğŸ‡³ğŸ‡¨
new zealand	ğŸ‡³ğŸ‡¿
news, newspaper	ğŸ“°  ğŸ—
next scene, next track	â­
ng	ğŸ†–
nib	âœ’  ğŸ”
nicaragua	ğŸ‡³ğŸ‡®
niger	ğŸ‡³ğŸ‡ª
nigeria	ğŸ‡³ğŸ‡¬
night	ğŸŒƒ  ğŸŒ‰
niue	ğŸ‡³ğŸ‡º
norfolk	ğŸ‡³ğŸ‡«
north	ğŸ‡°ğŸ‡µ  â¬†
northeast	â†—
northern	ğŸ‡²ğŸ‡µ  ğŸ‡¬ğŸ‡§
northwest	â†–
norway	ğŸ‡³ğŸ‡´
nose	ğŸ‘ƒ  ğŸ½
note	ğŸµ  ğŸ¶  ğŸ’´  ğŸ’µ  ğŸ’¶  ğŸ’·  ğŸ’¸  ğŸ—’
notebook	ğŸ“”  ğŸ““  ğŸ“’
notes	ğŸ¶
o	â­•  ğŸ…¾
objects	ğŸ’§  ğŸ’£  ğŸ’¦  ğŸ’¨  ğŸ•¶  ğŸ©  ğŸ•·  ğŸ•¸  ğŸ’©  ğŸ’  ğŸ’®  â›²  ğŸ«  ğŸ­  ğŸ°  ğŸ› 
ğŸšª  ğŸ›Œ  ğŸ›  ğŸ›‹  ğŸš½  ğŸš¿  ğŸ›€  ğŸ›  ğŸ›  ğŸ•°  â˜„  ğŸ•¹  ğŸ“¯  ğŸ™  ğŸš  ğŸ› 
ğŸ“»  ğŸ“±  ğŸ“³  ğŸ“´  ğŸ“²  ğŸ“µ  ğŸ“¶  ğŸ¥  ğŸ¦  ğŸ¬  ğŸ“½  ğŸ“º  ğŸ“·  ğŸ“¸  ğŸ“¹  ğŸ“¼ 
ğŸ”  ğŸ”  ğŸ”¬  ğŸ”­  ğŸ”¥  ğŸ•¯  ğŸ’¡  ğŸ”¦  ğŸƒ  ğŸ„  ğŸ†  ğŸ‡  ğŸˆ  ğŸ‰  ğŸŠ  ğŸ‹ 
ğŸ  ğŸ  ğŸ  ğŸ‘  ğŸ“  ğŸ¨  ğŸ¯  ğŸ´  ğŸ€  ğŸ  ğŸ–  ğŸ—  ğŸ  ğŸŸ  ğŸ·  ğŸ“° 
ğŸ—  ğŸ”–  ğŸ–¼  ğŸ”’  ğŸ”“  ğŸ”  ğŸ”  ğŸ”‘  ğŸ—  ğŸ”¨  â›  âš’  ğŸ›   ğŸ”§  ğŸ”©  âš™ 
ğŸ—œ  âš—  âš–  ğŸ’‰  ğŸ—¡  ğŸ”ª  âš”  ğŸ”«  ğŸ›¡  ğŸ’  ğŸ”‹  ğŸ”Œ  ğŸ”—  â›“  ğŸš¬  ğŸ’„ 
ğŸ’  ğŸ’  ğŸ›¢  ğŸ”®  ğŸ”¯  ğŸ”±  ğŸ—³  ğŸ’Š  âš›  âšœ  âš°  âš±  ğŸ”°  â˜¸
â›³ ğŸŒ ğŸ ğŸ“« ğŸ“ª ğŸ“¬ ğŸ“­ ğŸ ğŸ³ ğŸ´ ğŸš©ğŸ½
 ğŸ’ ğŸ’¬ ğŸ’­ ğŸ‘“ ğŸ‘” ğŸ‘• ğŸ‘– ğŸ‘— ğŸ‘˜ ğŸ‘™ ğŸ‘š ğŸ‘› ğŸ‘œ ğŸ‘ ğŸ‘ ğŸ‘Ÿ ğŸ‘  ğŸ‘¡ ğŸ‘¢ ğŸ‘‘ ğŸ‘’  ğŸ‡ ğŸˆ ğŸ‰ ğŸŠ ğŸ‹ ğŸŒ ğŸ ğŸ ğŸ ğŸ ğŸ‘ ğŸ’ ğŸ“ ğŸ… ğŸ† ğŸŒ½ ğŸ ğŸ– ğŸ— ğŸ” ğŸŸ ğŸ• 
ğŸ² ğŸ± ğŸ˜ ğŸ™ ğŸš ğŸ› ğŸœ ğŸ ğŸ  ğŸ¢ ğŸ£ ğŸ¤ ğŸ¥ ğŸ¡ ğŸ¦ ğŸ§ ğŸ¨ ğŸ© ğŸª ğŸ‚ ğŸ° ğŸ« ğŸ¬ ğŸ­ ğŸ® ğŸ¯ â˜• ğŸµ ğŸ¶ ğŸ· ğŸ¸ ğŸ¹ ğŸº ğŸ» ğŸ¼ ğŸ´ ğŸ³ â›º  ğŸ’º âŒ› 
â³ âŒš â° ğŸ² ğŸƒ ğŸ€„ ğŸ® âš½ âš¾ ğŸ€ ğŸˆ ğŸ‰ ğŸ¾ ğŸ± ğŸ³ â›³ ğŸ£ ğŸ¿ ğŸ† ğŸ”‡ ğŸ”ˆ ğŸ”‰ ğŸ”Š ğŸ“¢ ğŸ“£ ğŸ”” ğŸ”• ğŸ¼ ğŸµ ğŸ¶ ğŸ¤ ğŸ§ ğŸ· ğŸ¸ ğŸ¹ ğŸº ğŸ» â˜ ğŸ“ ğŸ“Ÿ ğŸ“  ğŸ”… ğŸ”† ğŸŒ ğŸ 
ğŸ“” ğŸ“• ğŸ“– ğŸ“— ğŸ“˜ ğŸ“™ ğŸ“š ğŸ““ ğŸ“’ ğŸ“ƒ ğŸ“œ ğŸ“„ ğŸ“‘ ğŸ’° ğŸ’´ ğŸ’µ ğŸ’¶ ğŸ’· ğŸ’¸ ğŸ’± ğŸ’² ğŸ’³ ğŸ’¹ âœ‰ ğŸ“§ ğŸ“¨ ğŸ“© ğŸ“¤ ğŸ“¥ ğŸ“¦ ğŸ“« ğŸ“ª ğŸ“¬ ğŸ“­ ğŸ“® âœ âœ’ ğŸ“ ğŸ’» ğŸ’½ ğŸ’¾ ğŸ’¿ ğŸ“€ ğŸ’¼
 ğŸ“ ğŸ“‚ ğŸ“… ğŸ“† ğŸ“‡ ğŸ“ˆ ğŸ“‰ ğŸ“Š ğŸ“‹ ğŸ“Œ ğŸ“ ğŸ“ ğŸ“ ğŸ“ ğŸ“› âœ‚ ğŸ“¡ ğŸ 
 ğŸ–‹ ğŸ–Š ğŸ–Œ ğŸ– ğŸ–¥ ğŸ–¨ âŒ¨ ğŸ–± ğŸ–² ğŸ—‚ ğŸ—’ ğŸ—“ ğŸ–‡ ğŸ—ƒ ğŸ—„ ğŸ—‘
 â± â² ğŸ…
objects-android	ğŸ’£  ğŸ’¬  ğŸ’­  ğŸ‘“  ğŸ‘”  ğŸ‘•  ğŸ‘–  ğŸ‘—  ğŸ‘˜  ğŸ‘™  ğŸ‘š  ğŸ‘›  ğŸ‘œ  ğŸ‘  ğŸ‘  ğŸ‘Ÿ 
ğŸ‘   ğŸ‘¡  ğŸ‘¢  ğŸ‘‘  ğŸ‘’  ğŸ©  ğŸ‚  â›º  ğŸ   ğŸ¡  ğŸ¢  ğŸª  ğŸ«  ğŸ­  ğŸ°  ğŸ’º 
ğŸšª  âŒš  ğŸ²  ğŸƒ  ğŸ€„  ğŸ®  ğŸ“¢  ğŸ“£  ğŸ“¯  ğŸ””  ğŸ”•  ğŸ¼  ğŸµ  ğŸ¶  ğŸ¤  ğŸ§ 
ğŸ·  ğŸ¸  ğŸ¹  ğŸº  ğŸ»  ğŸ“»  ğŸ“±  ğŸ“²  â˜  ğŸ“  ğŸ“Ÿ  ğŸ“   ğŸ¥  ğŸ¦  ğŸ¬  ğŸ“º 
ğŸ“·  ğŸ“¹  ğŸ“¼  ğŸ”¬  ğŸ”­  ğŸ”¦  ğŸƒ  ğŸ„  ğŸ†  ğŸ‡  ğŸˆ  ğŸ‰  ğŸŠ  ğŸ‹  ğŸŒ  ğŸ 
ğŸ  ğŸ  ğŸ  ğŸ“  ğŸ¨  ğŸ¯  ğŸ´  ğŸ€  ğŸ  ğŸ“”  ğŸ“•  ğŸ“–  ğŸ“—  ğŸ“˜  ğŸ“™  ğŸ“š 
ğŸ““  ğŸ“’  ğŸ“ƒ  ğŸ“œ  ğŸ“„  ğŸ“°  ğŸ“‘  ğŸ’°  ğŸ’´  ğŸ’µ  ğŸ’¶  ğŸ’·  ğŸ’¸  ğŸ’±  ğŸ’²  ğŸ’³ 
ğŸ’¹  âœ‰  ğŸ“¨  ğŸ“©  ğŸ“¤  ğŸ“¥  ğŸ“¦  ğŸ“«  ğŸ“ª  ğŸ“¬  ğŸ“­  ğŸ“®  âœ  âœ’  ğŸ“  ğŸ’» 
ğŸ’½  ğŸ’¾  ğŸ’¿  ğŸ“€  ğŸ’¼  ğŸ“  ğŸ“‚  ğŸ“…  ğŸ“†  ğŸ“‡  ğŸ“ˆ  ğŸ“‰  ğŸ“Š  ğŸ“‹  ğŸ“Œ  ğŸ“ 
ğŸ“  ğŸ“  ğŸ“  ğŸ“›  âœ‚  ğŸ’‰  ğŸ”ª  ğŸ”«  ğŸ’  ğŸ”‹  ğŸ”Œ  ğŸš¬  ğŸ’„  ğŸ”®  ğŸ’Š  ğŸ”° 
ğŸ“¡  ã€½
objects-apple	ğŸ…  ğŸ’  ğŸ’£  ğŸ‘»  ğŸ‘¾  ğŸ‡  ğŸˆ  ğŸ‰  ğŸŠ  ğŸ‹  ğŸŒ  ğŸ  ğŸ  ğŸ  ğŸ  ğŸ‘ 
ğŸ’  ğŸ“  ğŸ…  ğŸ†  ğŸŒ½  ğŸ  ğŸ–  ğŸ—  ğŸ”  ğŸŸ  ğŸ•  ğŸ²  ğŸ±  ğŸ˜  ğŸ™  ğŸš 
ğŸ›  ğŸœ  ğŸ  ğŸ   ğŸ¢  ğŸ£  ğŸ¤  ğŸ¥  ğŸ¡  ğŸ¦  ğŸ§  ğŸ¨  ğŸ©  ğŸª  ğŸ‚  ğŸ° 
ğŸ«  ğŸ¬  ğŸ­  ğŸ®  ğŸ¯  â˜•  ğŸµ  ğŸ¶  ğŸ·  ğŸ¸  ğŸ¹  ğŸº  ğŸ»  ğŸ¼  ğŸ´  ğŸ³ 
ğŸš´  ğŸšµ  ğŸšª  ğŸš½  ğŸš¿  ğŸ›€  ğŸ›  âŒ›  â³  âŒš  â°  ğŸ²  ğŸƒ  ğŸ€„  ğŸ®  âš½ 
âš¾  ğŸ€  ğŸˆ  ğŸ‰  ğŸ¾  ğŸ±  ğŸ³  â›³  ğŸ£  ğŸ¿  ğŸ‚  ğŸ„  ğŸ‡  ğŸŠ  ğŸ†  ğŸ”‡ 
ğŸ”ˆ  ğŸ”‰  ğŸ”Š  ğŸ“¢  ğŸ“£  ğŸ“¯  ğŸ””  ğŸ”•  ğŸ¼  ğŸµ  ğŸ¶  ğŸ¤  ğŸ§  ğŸ·  ğŸ¸  ğŸ¹ 
ğŸº  ğŸ»  ğŸ“»  ğŸ“±  ğŸ“²  â˜  ğŸ“  ğŸ“Ÿ  ğŸ“   ğŸ¥  ğŸ¬  ğŸ“º  ğŸ“·  ğŸ“¹  ğŸ“¼  ğŸ”… 
ğŸ”†  ğŸ”  ğŸ”  ğŸ”¬  ğŸ”­  ğŸ’¡  ğŸ”¦  ğŸƒ  ğŸ„  ğŸ†  ğŸ‡  ğŸˆ  ğŸ‰  ğŸŠ  ğŸ‹  ğŸŒ 
ğŸ  ğŸ  ğŸ  ğŸ  ğŸ‘  ğŸ“  ğŸ¨  ğŸ¯  ğŸ´  ğŸ  ğŸ“”  ğŸ“•  ğŸ“–  ğŸ“—  ğŸ“˜  ğŸ“™ 
ğŸ“š  ğŸ““  ğŸ“’  ğŸ“ƒ  ğŸ“œ  ğŸ“„  ğŸ“°  ğŸ“‘  ğŸ”–  ğŸ’°  ğŸ’´  ğŸ’µ  ğŸ’¶  ğŸ’·  ğŸ’¸  ğŸ’³ 
âœ‰  ğŸ“§  ğŸ“¨  ğŸ“©  ğŸ“¤  ğŸ“¥  ğŸ“¦  ğŸ“«  ğŸ“ª  ğŸ“¬  ğŸ“­  ğŸ“®  âœ  âœ’  ğŸ“  ğŸ’» 
ğŸ’½  ğŸ’¾  ğŸ’¿  ğŸ“€  ğŸ“  ğŸ“‚  ğŸ“…  ğŸ“†  ğŸ“‡  ğŸ“ˆ  ğŸ“‰  ğŸ“Š  ğŸ“‹  ğŸ“Œ  ğŸ“  ğŸ“ 
ğŸ“  ğŸ“›  âœ‚  ğŸ”’  ğŸ”“  ğŸ”  ğŸ”  ğŸ”‘  ğŸ”¨  ğŸ”§  ğŸ”©  ğŸ’‰  ğŸ”ª  ğŸ”«  ğŸ’  ğŸ”‹ 
ğŸ”Œ  ğŸš¬  ğŸ”®  ğŸ’Š  ğŸ“¡  ğŸ
ocean	ğŸŒŠ  ğŸ‡®ğŸ‡´
octopus	ğŸ™
off	ğŸ“´
office	ğŸ¢  ğŸ£  ğŸ¤  ğŸ’º  â˜  ğŸ“Ÿ  ğŸ“   ğŸ“”  ğŸ“•  ğŸ“–  ğŸ“—  ğŸ“˜  ğŸ“™  ğŸ“š  ğŸ““  ğŸ“’ 
ğŸ“ƒ  ğŸ“œ  ğŸ“„  ğŸ“‘  ğŸ–¼  ğŸ’°  ğŸ’´  ğŸ’µ  ğŸ’¶  ğŸ’·  ğŸ’¸  ğŸ’±  ğŸ’²  ğŸ’³  ğŸ’¹  âœ‰ 
ğŸ“§  ğŸ“¨  ğŸ“©  ğŸ“¤  ğŸ“¥  ğŸ“¦  ğŸ“«  ğŸ“ª  ğŸ“¬  ğŸ“­  ğŸ“®  âœ  âœ’  ğŸ–‹  ğŸ–Š  ğŸ–Œ 
ğŸ–  ğŸ“  ğŸ’»  ğŸ–¥  ğŸ–¨  ğŸ–±  ğŸ–²  ğŸ’½  ğŸ’¾  ğŸ’¿  ğŸ“€  ğŸ’¼  ğŸ“  ğŸ“‚  ğŸ—‚  ğŸ“… 
ğŸ“†  ğŸ—’  ğŸ—“  ğŸ“‡  ğŸ“ˆ  ğŸ“‰  ğŸ“Š  ğŸ“‹  ğŸ“Œ  ğŸ“  ğŸ“  ğŸ–‡  ğŸ“  ğŸ“  ğŸ“›  âœ‚ 
ğŸ—ƒ  ğŸ—„  ğŸ—‘  ğŸ’¯  ğŸ“¡
ogre	ğŸ‘¹
oh	ğŸ™€
ok	ğŸ™†  ğŸ‘Œ  ğŸ†—
old	ğŸ‘´  ğŸ‘µ  ğŸ—
oman	ğŸ‡´ğŸ‡²
on	ğŸ”›
once	ğŸ”‚
oncoming	ğŸš  ğŸš”  ğŸš–  ğŸš˜
open	ğŸ˜ƒ  ğŸ˜„  ğŸ˜…  ğŸ˜†  ğŸ˜¦  ğŸ˜®  ğŸ˜°  ğŸ‘  ğŸ˜º  ğŸ“–  ğŸ“¬  ğŸ“­  ğŸ“‚  ğŸ”“
ophiuchus	â›
optical	ğŸ’½  ğŸ’¿  ğŸ“€
orange	ğŸŠ  ğŸ“™  ğŸ”¶  ğŸ”¸
other-android	ğŸ…  #âƒ£  0âƒ£  1âƒ£  2âƒ£  3âƒ£  4âƒ£  5âƒ£  6âƒ£  7âƒ£  8âƒ£  9âƒ£  ğŸ”Ÿ  ğŸ‡¨ğŸ‡³  ğŸ‡«ğŸ‡·  ğŸ‡©ğŸ‡ª 
ğŸ‡®ğŸ‡¹  ğŸ‡¯ğŸ‡µ  ğŸ‡·ğŸ‡º  ğŸ‡°ğŸ‡·  ğŸ‡ªğŸ‡¸  ğŸ‡¬ğŸ‡§  ğŸ‡ºğŸ‡¸
outbox	ğŸ“¤
outgoing	ğŸ“©
outlined	â˜º  ğŸ”³  â”  â•
outlying	ğŸ‡ºğŸ‡²
ox	ğŸ‚
package, parcel	ğŸ“¦
pad	ğŸ—’  ğŸ—“
pager	ğŸ“Ÿ
paintbrush	ğŸ–Œ
painting	ğŸ¨  ğŸ–¼  ğŸ–Œ
pakistan	ğŸ‡µğŸ‡°
palau	ğŸ‡µğŸ‡¼
palestine	ğŸ‡µğŸ‡¸
palette	ğŸ¨
palm	â¸™  ğŸŒ´
panama	ğŸ‡µğŸ‡¦
panda	ğŸ¼
paper	ğŸ“œ  ğŸ“°  ğŸ—
paperclip	ğŸ“  ğŸ–‡
papua new guinea	ğŸ‡µğŸ‡¬
paraguay	ğŸ‡µğŸ‡¾
parking	ğŸ…¿
part	ã€½
party, popper, tada	ğŸ‰
passenger	ğŸ›³
passport	ğŸ›‚
password	ğŸ”‘
pasta, spaghetti	ğŸ
patrol	ğŸš“
pause	â¯  â¸
pc, personal	ğŸ’»
peace	ğŸ•Š  â˜®
peach	ğŸ‘
pear	ğŸ
pedestrian	ğŸš¶  ğŸš·  ğŸš¸
pen	âœ’  ğŸ–‹  ğŸ–Š  ğŸ”
pencil	âœ  ğŸ“
penguin	ğŸ§
people-android	â˜º  ğŸ˜€  ğŸ˜  ğŸ˜‚  ğŸ˜ƒ  ğŸ˜„  ğŸ˜…  ğŸ˜†  ğŸ˜‰  ğŸ˜Š  ğŸ˜‹  ğŸ˜Œ  ğŸ˜  ğŸ˜  ğŸ˜  ğŸ˜ 
ğŸ˜‘  ğŸ˜’  ğŸ˜“  ğŸ˜”  ğŸ˜•  ğŸ˜–  ğŸ˜—  ğŸ˜˜  ğŸ˜™  ğŸ˜š  ğŸ˜›  ğŸ˜œ  ğŸ˜  ğŸ˜  ğŸ˜Ÿ  ğŸ˜  
ğŸ˜¡  ğŸ˜¢  ğŸ˜£  ğŸ˜¤  ğŸ˜¥  ğŸ˜¦  ğŸ˜§  ğŸ˜¨  ğŸ˜©  ğŸ˜ª  ğŸ˜«  ğŸ˜¬  ğŸ˜­  ğŸ˜®  ğŸ˜¯  ğŸ˜° 
ğŸ˜±  ğŸ˜²  ğŸ˜³  ğŸ˜´  ğŸ˜µ  ğŸ˜¶  ğŸ˜·  ğŸ˜‡  ğŸ˜ˆ  ğŸ‘¿  ğŸ‘¦  ğŸ‘§  ğŸ‘¨  ğŸ‘©  ğŸ‘´  ğŸ‘µ 
ğŸ‘¶  ğŸ‘±  ğŸ‘®  ğŸ‘²  ğŸ‘³  ğŸ‘·  ğŸ‘¸  ğŸ’‚  ğŸ…  ğŸ‘¼  ğŸ‘¯  ğŸ’†  ğŸ’‡  ğŸ‘°  ğŸ™  ğŸ™ 
ğŸ™…  ğŸ™†  ğŸ’  ğŸ™‹  ğŸ™‡  ğŸ™Œ  ğŸ™  ğŸ‘¤  ğŸ‘¥  ğŸ’ƒ  ğŸ’  ğŸ’‘  ğŸ‘ª  ğŸ‘«  ğŸ‘¬  ğŸ‘­ 
ğŸ‘ˆ  ğŸ‘‰  â˜  ğŸ‘†  ğŸ‘‡  âœŒ  âœŠ  âœ‹  ğŸ‘Š  ğŸ‘‹  ğŸ‘Œ  ğŸ‘  ğŸ‘  ğŸ‘  ğŸ‘  ğŸ’… 
ğŸ’ª  ğŸ‘£  ğŸ‘€  ğŸ‘‚  ğŸ‘ƒ  ğŸ‘…  ğŸ’€  ğŸ’‹  ğŸ‘„  ğŸ’˜  â¤  ğŸ’“  ğŸ’”  ğŸ’•  ğŸ’–  ğŸ’— 
ğŸ’™  ğŸ’š  ğŸ’›  ğŸ’œ  ğŸ’  ğŸ’  ğŸ’Ÿ  ğŸ™ˆ  ğŸ™‰  ğŸ™Š  ğŸ˜¸  ğŸ˜¹  ğŸ˜º  ğŸ˜»  ğŸ˜¼  ğŸ˜½ 
ğŸ˜¾  ğŸ˜¿  ğŸ™€  ğŸ’©  ğŸ‘¹  ğŸ‘º  ğŸ‘»  ğŸ‘½  ğŸ‘¾
people-apple	â˜º  ğŸ˜€  ğŸ˜  ğŸ˜‚  ğŸ˜ƒ  ğŸ˜„  ğŸ˜…  ğŸ˜†  ğŸ˜‰  ğŸ˜Š  ğŸ˜‹  ğŸ˜Œ  ğŸ˜  ğŸ˜  ğŸ˜  ğŸ˜ 
ğŸ˜‘  ğŸ˜’  ğŸ˜“  ğŸ˜”  ğŸ˜•  ğŸ˜–  ğŸ˜—  ğŸ˜˜  ğŸ˜™  ğŸ˜š  ğŸ˜›  ğŸ˜œ  ğŸ˜  ğŸ˜  ğŸ˜Ÿ  ğŸ˜  
ğŸ˜¡  ğŸ˜¢  ğŸ˜£  ğŸ˜¤  ğŸ˜¥  ğŸ˜¦  ğŸ˜§  ğŸ˜¨  ğŸ˜©  ğŸ˜ª  ğŸ˜«  ğŸ˜¬  ğŸ˜­  ğŸ˜®  ğŸ˜¯  ğŸ˜° 
ğŸ˜±  ğŸ˜²  ğŸ˜³  ğŸ˜´  ğŸ˜µ  ğŸ˜¶  ğŸ˜·  ğŸ˜‡  ğŸ˜ˆ  ğŸ‘¿  ğŸ‘¦  ğŸ‘§  ğŸ‘¨  ğŸ‘©  ğŸ‘´  ğŸ‘µ 
ğŸ‘¶  ğŸ‘±  ğŸ‘®  ğŸ‘²  ğŸ‘³  ğŸ‘·  ğŸ‘¸  ğŸ’‚  ğŸ‘¼  ğŸ‘¯  ğŸ’†  ğŸ’‡  ğŸ‘°  ğŸ™  ğŸ™  ğŸ™… 
ğŸ™†  ğŸ’  ğŸ™‹  ğŸ™‡  ğŸ™Œ  ğŸ™  ğŸ‘¤  ğŸ‘¥  ğŸš¶  ğŸƒ  ğŸ’ƒ  ğŸ’  ğŸ’‘  ğŸ‘ª  ğŸ‘«  ğŸ‘¬ 
ğŸ‘­  ğŸ‘ˆ  ğŸ‘‰  â˜  ğŸ‘†  ğŸ‘‡  âœŒ  âœŠ  âœ‹  ğŸ‘Š  ğŸ‘‹  ğŸ‘Œ  ğŸ‘  ğŸ‘  ğŸ‘  ğŸ‘ 
ğŸ’…  ğŸ’ª  ğŸ‘£  ğŸ‘€  ğŸ‘‚  ğŸ‘ƒ  ğŸ‘…  ğŸ’€  ğŸ’‹  ğŸ‘„  ğŸ’˜  â¤  ğŸ’“  ğŸ’”  ğŸ’•  ğŸ’– 
ğŸ’—  ğŸ’™  ğŸ’š  ğŸ’›  ğŸ’œ  ğŸ’  ğŸ’Œ  ğŸ’§  ğŸ’¤  ğŸ’¢  ğŸ’¥  ğŸ’¦  ğŸ’¨  ğŸ’«  ğŸ’¬  ğŸ’­ 
ğŸ‘“  ğŸ‘”  ğŸ‘•  ğŸ‘–  ğŸ‘—  ğŸ‘˜  ğŸ‘™  ğŸ‘š  ğŸ‘›  ğŸ‘œ  ğŸ‘  ğŸ‘  ğŸ‘Ÿ  ğŸ‘   ğŸ‘¡  ğŸ‘¢ 
ğŸ‘‘  ğŸ‘’  ğŸ©  ğŸ™ˆ  ğŸ™‰  ğŸ™Š  ğŸ˜¸  ğŸ˜¹  ğŸ˜º  ğŸ˜»  ğŸ˜¼  ğŸ˜½  ğŸ˜¾  ğŸ˜¿  ğŸ™€  ğŸ’© 
ğŸ‘¹  ğŸ‘º  ğŸ‘½  ğŸŒ‚  ğŸŒŸ  ğŸ½  ğŸ”¥  âœ¨  ğŸ€  ğŸ’¼  ğŸ’„  ğŸ’  ğŸ’
pepper	ğŸŒ¶
performing, theater, theatre	ğŸ­
persevere	ğŸ˜£
person	ğŸ‘¦  ğŸ‘§  ğŸ‘¨  ğŸ‘©  ğŸ‘´  ğŸ‘µ  ğŸ‘¶  ğŸ‘±  ğŸ‘®  ğŸ‘²  ğŸ‘³  ğŸ‘·  ğŸ‘¸  ğŸ’‚  ğŸ…  ğŸ•µ 
ğŸ‘¯  ğŸ’†  ğŸ’‡  ğŸ‘°  ğŸ™  ğŸ™  ğŸ™…  ğŸ™†  ğŸ’  ğŸ™‹  ğŸ™‡  ğŸ™Œ  ğŸ™  ğŸ—£  ğŸ‘¤  ğŸ‘¥ 
ğŸš¶  ğŸƒ  ğŸ’ƒ  ğŸ•´  ğŸ’  ğŸ’‘  ğŸ‘ª  ğŸ‘«  ğŸ‘¬  ğŸ‘­  ğŸš´  ğŸšµ  ğŸ  ğŸŒ  â›·  ğŸ‚ 
ğŸ„  ğŸ‡  ğŸŠ  â›¹  ğŸ‹
peru	ğŸ‡µğŸ‡ª
pet	ğŸ¶  ğŸ•  ğŸ±  ğŸˆ  ğŸ¹  ğŸ°  ğŸ‡
philippines	ğŸ‡µğŸ‡­
phone	ğŸ“±  ğŸ“³  ğŸ“´  ğŸ“²  ğŸ“µ  â˜  ğŸ“  ğŸ“¶
piano	ğŸ¹
pick	â›  âš’
pig	ğŸ·  ğŸ–  ğŸ½
pill	ğŸ’Š
pin, pushpin	ğŸ“Œ  ğŸ“
pineapple	ğŸ
pisces	â™“
pitcairn	ğŸ‡µğŸ‡³
pizza	ğŸ•
places	ğŸŒ  ğŸŒ  ğŸŒ  ğŸŒ  ğŸ—º  ğŸ”  â›°  ğŸŒ‹  ğŸ—»  ğŸ•  ğŸ–  ğŸœ  ğŸ  ğŸ  ğŸŸ  ğŸ› 
ğŸ—  ğŸ˜  ğŸ™  ğŸš  ğŸ   ğŸ¡  â›ª  ğŸ¢  ğŸ£  ğŸ¤  ğŸ¥  ğŸ¦  ğŸ¨  ğŸ©  ğŸª  ğŸ« 
ğŸ¬  ğŸ­  ğŸ¯  ğŸ°  ğŸ’’  ğŸ—¼  ğŸ—½  ğŸ—¾  â›²  â›º  ğŸŒ  ğŸŒƒ  ğŸŒ„  ğŸŒ…  ğŸŒ†  ğŸŒ‡ 
ğŸŒ‰  ğŸŒŠ  ğŸŒŒ  ğŸ   ğŸ¡  ğŸ¢  ğŸ’ˆ  ğŸª  ğŸ«  ğŸ­  ğŸ°  ğŸ›°  ğŸ§  ğŸš®  ğŸŒ‘  ğŸŒ’ 
ğŸŒ“  ğŸŒ”  ğŸŒ•  ğŸŒ–  ğŸŒ—  ğŸŒ˜  ğŸŒ™  ğŸŒš  ğŸŒ›  ğŸŒœ  ğŸŒ  ğŸŒ  ğŸŒŸ  ğŸŒ   ğŸ®  ğŸ“ 
ğŸ ğŸ’ â™¨ ğŸ—¿ ğŸš‚ ğŸšƒ ğŸš„ ğŸš… ğŸš† ğŸš‡ ğŸšˆ ğŸš‰ ğŸšŠ ğŸš ğŸš ğŸš‹ ğŸšŒ ğŸš ğŸš
ğŸš ğŸš ğŸš‘ ğŸš’ ğŸš“ ğŸš” ğŸš• ğŸš– ğŸš— ğŸš˜ ğŸš™ ğŸšš ğŸš› ğŸšœ ğŸš² ğŸš³ ğŸš´ ğŸšµ â›½ ğŸš¨ âš“ â›µ ğŸš£ 
ğŸš¤ ğŸš¢ âœˆ ğŸ’º ğŸš ğŸšŸ ğŸš  ğŸš¡ ğŸš€ ğŸš¥ ğŸš¦ ğŸš§ ğŸš· ğŸš¸ ğŸš¾ ğŸ›‚ ğŸ›ƒ ğŸ›„ ğŸ›… âš  ğŸš½ 
ğŸš¿ ğŸ›€ ğŸ› âš½ âš¾ ğŸ€ ğŸˆ ğŸ‰ ğŸ¾ ğŸ± ğŸ³ â›³ ğŸ£ ğŸ½ 
ğŸ½ ğŸ ğŸ›£ ğŸ›¤ âˆ ğŸ›³ â›´ ğŸ›¥ ğŸ›© ğŸ›« ğŸ›¬  â›¸
 ğŸ† ğŸ ğŸš©â“‚ ğŸ…¿
places-android	ğŸš¶  ğŸƒ  ğŸ’Œ  ğŸ  ğŸ’  ğŸ—»  ğŸ   ğŸ¡  â›ª  ğŸ¢  ğŸ£  ğŸ¤  ğŸ¥  ğŸ¦  ğŸ¨  ğŸ© 
ğŸª  ğŸ«  ğŸ¬  ğŸ­  ğŸ¯  ğŸ°  ğŸ’’  ğŸ—¼  ğŸ—½  ğŸ—¾  â›²  â™¨  ğŸ—¿  ğŸ’ˆ  ğŸš‚  ğŸšƒ 
ğŸš„  ğŸš…  ğŸš†  ğŸš‡  ğŸšˆ  ğŸš‰  ğŸšŠ  ğŸš  ğŸš  ğŸš‹  ğŸšŒ  ğŸš  ğŸš  ğŸš  ğŸš  ğŸš‘ 
ğŸš’  ğŸš“  ğŸš”  ğŸš•  ğŸš–  ğŸš—  ğŸš˜  ğŸš™  ğŸšš  ğŸš›  ğŸšœ  ğŸš²  ğŸš³  ğŸš´  ğŸšµ  â›½ 
ğŸš¨  âš“  â›µ  ğŸš£  ğŸš¤  ğŸš¢  âœˆ  ğŸš  ğŸšŸ  ğŸš   ğŸš¡  ğŸš€  ğŸ§  ğŸš¥  ğŸš¦  ğŸš§ 
ğŸš·  ğŸš¸  ğŸš¾  ğŸ›‚  ğŸ›ƒ  ğŸ›„  ğŸ›…  ğŸš½  ğŸš¿  ğŸ›€  ğŸ›  âš½  âš¾  ğŸ€  ğŸˆ  ğŸ‰ 
ğŸ¾  ğŸ±  ğŸ³  â›³  ğŸ£  ğŸ½  ğŸ¿  ğŸ‚  ğŸ„  ğŸ‡  ğŸŠ  ğŸ†  ğŸ®  ğŸ”¨  ğŸ”§  ğŸ”© 
ğŸ’  ğŸ’  ğŸ  â“‚  ğŸ…¿
places-apple	ğŸ—»  ğŸ   ğŸ¡  â›ª  ğŸ¢  ğŸ£  ğŸ¤  ğŸ¥  ğŸ¦  ğŸ¨  ğŸ©  ğŸª  ğŸ«  ğŸ¬  ğŸ­  ğŸ¯ 
ğŸ°  ğŸ’’  ğŸ—¼  ğŸ—½  ğŸ—¾  â›²  â›º  ğŸŒƒ  ğŸŒ„  ğŸŒ…  ğŸŒ†  ğŸŒ‡  ğŸŒ‰  â™¨  ğŸ—¿  ğŸ  
ğŸ¡  ğŸ¢  ğŸ’ˆ  ğŸª  ğŸ«  ğŸ­  ğŸ°  ğŸš‚  ğŸšƒ  ğŸš„  ğŸš…  ğŸš†  ğŸš‡  ğŸšˆ  ğŸš‰  ğŸšŠ 
ğŸš  ğŸš  ğŸš‹  ğŸšŒ  ğŸš  ğŸš  ğŸš  ğŸš  ğŸš‘  ğŸš’  ğŸš“  ğŸš”  ğŸš•  ğŸš–  ğŸš—  ğŸš˜ 
ğŸš™  ğŸšš  ğŸš›  ğŸšœ  ğŸš²  â›½  ğŸš¨  âš“  â›µ  ğŸš£  ğŸš¤  ğŸš¢  âœˆ  ğŸ’º  ğŸš  ğŸšŸ 
ğŸš   ğŸš¡  ğŸš€  ğŸš¥  ğŸš¦  ğŸš§  âš   ğŸ®  ğŸ“  ğŸ”°  ğŸš©  ğŸ‡¨ğŸ‡³  ğŸ‡«ğŸ‡·  ğŸ‡©ğŸ‡ª  ğŸ‡®ğŸ‡¹  ğŸ‡¯ğŸ‡µ 
ğŸ‡·ğŸ‡º  ğŸ‡°ğŸ‡·  ğŸ‡ªğŸ‡¸  ğŸ‡¬ğŸ‡§  ğŸ‡ºğŸ‡¸
plant	ğŸŒ¸  ğŸŒ¹  ğŸŒº  ğŸŒ»  ğŸŒ¼  ğŸŒ·  â¸™  â˜˜  ğŸŒ±  ğŸŒ²  ğŸŒ³  ğŸŒ´  ğŸŒµ  ğŸŒ¾  ğŸŒ¿  ğŸ€ 
ğŸ  ğŸ‚  ğŸƒ  ğŸ‡  ğŸˆ  ğŸ‰  ğŸŠ  ğŸ‹  ğŸŒ  ğŸ  ğŸ  ğŸ  ğŸ  ğŸ‘  ğŸ’  ğŸ“ 
ğŸ…  ğŸ†  ğŸŒ½  ğŸŒ¶  ğŸ„  ğŸŒ°  ğŸ
plate	ğŸ½
play, right	â–¶  â¯
playing	ğŸƒ  ğŸ´
plug	ğŸ”Œ
plus	â•
point	ğŸ‘ˆ  ğŸ‘‰  â˜  ğŸ‘†  ğŸ‘‡
poland	ğŸ‡µğŸ‡±
pole	ğŸ’ˆ  ğŸ£
police	ğŸ‘®  ğŸš“  ğŸš”  ğŸš¨
polynesia	ğŸ‡µğŸ‡«
poodle	ğŸ©
portugal	ğŸ‡µğŸ‡¹
post	ğŸ£  ğŸ¤  ğŸ“¯  ğŸš©
pot	ğŸ²  ğŸ¯
potable	ğŸš°  ğŸš±
potato, roasted	ğŸ 
pouch	ğŸ‘
pound	#âƒ£  ğŸ’·
pouting	ğŸ˜¡  ğŸ™  ğŸ˜¾
previous scene, previous track	â®
princess	ğŸ‘¸
principe, prÃ­ncipe, sao, sÃ£o, tome, tomÃ©	ğŸ‡¸ğŸ‡¹
print	ğŸ‘£  ğŸ¾
printer	ğŸ–¨
prize, trophy	ğŸ†
projector	ğŸ“½
puerto, rico	ğŸ‡µğŸ‡·
punctuation	â£  â€¼  â‰  â“  â”  â•  â—  ã€°
purple	ğŸ’œ
qatar	ğŸ‡¶ğŸ‡¦
quarter	ğŸŒ“  ğŸŒ—  ğŸŒ›  ğŸŒœ
question	â‰  â“  â”
quiet, silent	ğŸ˜¶  ğŸ”‡  ğŸ”•
rabbit	ğŸ°  ğŸ‡
racehorse	ğŸ  ğŸ‡
racing	ğŸ  ğŸ  ğŸ  ğŸ‡  ğŸ
racquet, tennis	ğŸ¾
radio	ğŸ“»  ğŸ”˜
radioactive	â˜¢
rage	ğŸ˜¡
railway	ğŸš‚  ğŸšƒ  ğŸš„  ğŸš…  ğŸš†  ğŸšˆ  ğŸš‰  ğŸš  ğŸ›¤  ğŸšŸ
rain	â›ˆ  ğŸŒ¦  ğŸŒ§  ğŸŒˆ  ğŸŒ‚  â˜‚  â˜”  â›±
rainbow	ğŸŒˆ
raised	ğŸ™‹  ğŸ™Œ
ram	ğŸ
rat	ğŸ€
rays, sunny	â˜€
receive	ğŸ“²  ğŸ“¨  ğŸ“¥
receiver	ğŸ“
record	âº
recreational, rv	ğŸš™
recycle	â™»
red	ğŸ˜¡  ğŸ  ğŸ€„  ğŸ”¼  ğŸ”½  ğŸ®  ğŸ”º  ğŸ”»  ğŸ”´
registered	Â®
relaxed	â˜º
relieved	ğŸ˜Œ  ğŸ˜¥
religion	â›ª  ğŸ•‰  âœ¡  â˜¸  â˜¯  âœ  â˜¦  â›©  â˜ª
reload	ğŸ”ƒ
reminder	ğŸ—
repeat	ğŸ”
resort, sailboat, sea, yacht	â›µ
restaurant	ğŸ  ğŸ–  ğŸ—  ğŸ”  ğŸŸ  ğŸ•  ğŸ²  ğŸ±  ğŸ˜  ğŸ™  ğŸš  ğŸ›  ğŸœ  ğŸ  ğŸ   ğŸ¢ 
ğŸ£  ğŸ¤  ğŸ¥  ğŸ¡  ğŸ¦  ğŸ§  ğŸ¨  ğŸ©  ğŸª  ğŸ°  ğŸ«  ğŸ¬  ğŸ­  ğŸ®  ğŸ¯  ğŸ¶ 
ğŸ·  ğŸ¸  ğŸ¹  ğŸº  ğŸ»  ğŸ½  ğŸ´  ğŸ³  ğŸ®
reunion, rÃ©union	ğŸ‡·ğŸ‡ª
revolving	ğŸ’  ğŸš¨
rewind	âª
ribbon	ğŸ’  ğŸ€  ğŸ—
rice	ğŸŒ¾  ğŸ˜  ğŸ™  ğŸš  ğŸ›
ring	ğŸ’
rocket	ğŸš€
rolled	ğŸ—
rolodex	ğŸ“‡
romance	ğŸ’  ğŸ’‘  ğŸ’‹  ğŸ’˜  ğŸ’Œ  ğŸ’  ğŸ’’  ğŸ’  ğŸ’
romania	ğŸ‡·ğŸ‡´
rooster	ğŸ“
rose	ğŸŒ¹
rosette	ğŸµ
rowboat	ğŸš£
rugby	ğŸ‰
ruler	ğŸ“  ğŸ“
running	ğŸƒ  ğŸ’¨  ğŸ½
rushed	ğŸ˜°
russia, russian	ğŸ‡·ğŸ‡º
rwanda	ğŸ‡·ğŸ‡¼
sagittarius	â™
sahara, western	ğŸ‡ªğŸ‡­
saint	ğŸ‡§ğŸ‡±  ğŸ‡¸ğŸ‡­  ğŸ‡°ğŸ‡³  ğŸ‡±ğŸ‡¨  ğŸ‡²ğŸ‡«  ğŸ‡µğŸ‡²  ğŸ‡»ğŸ‡¨
sake	ğŸ¶
samoa	ğŸ‡¦ğŸ‡¸  ğŸ‡¼ğŸ‡¸
san marino	ğŸ‡¸ğŸ‡²
sandal	ğŸ‘¡
sandwich	ğŸ‡¬ğŸ‡¸
santa	ğŸ…
sash	ğŸ½
sassy	ğŸ’
satchel	ğŸ’
satellite	ğŸ›°  ğŸ“¡
sax, saxophone	ğŸ·
school	ğŸ«  ğŸ’
scissors	âœ‚
score	ğŸ¼  ğŸ’¯
scorpion, scorpius	â™
scroll	ğŸ“œ
secret	ãŠ™
secure	ğŸ”
see	ğŸ™ˆ  ğŸ‡»ğŸ‡¦
seedling, young	ğŸŒ±
senegal	ğŸ‡¸ğŸ‡³
sent	ğŸ“©  ğŸ“¤
serbia	ğŸ‡·ğŸ‡¸
set	ğŸ“
seychelles	ğŸ‡¸ğŸ‡¨
shamrock	â˜˜
shaved	ğŸ§
sheep	ğŸ  ğŸ‘
shell	ğŸš
shield	ğŸ›¡
shinkansen, speed	ğŸš„  ğŸš…
shinto, shrine	â›©
ship	âš“  ğŸ›³  ğŸš¢  ğŸ”±
shirt	ğŸ‘•  ğŸ½
shoe	ğŸ‘  ğŸ‘Ÿ  ğŸ‘   ğŸ‘¡  ğŸ‘¢
shooting	ğŸŒ 
shopping	ğŸ›
shortcake	ğŸ°
shower	ğŸš¿
sick	ğŸ˜·  ğŸ’‰  ğŸ’Š
sierra leone	ğŸ‡¸ğŸ‡±
sign	ğŸš³  ğŸ§  ğŸš­  ğŸš¯  ğŸš°  ğŸš±  ğŸš·  ğŸš¸  â™¿  ğŸš¹  ğŸšº  ğŸš»  ğŸš¼  ğŸš¾  ğŸ›‚  ğŸ›ƒ 
ğŸ›„  ğŸ›…  ğŸ”…  ğŸ”†  âœ¨  âŒ¨  â˜¯  â˜®  â˜¢  â˜£  â™»  âœ…  â˜‘  âœ”  âœ–  âŒ 
â  â•  â–  â—  â°  â¿  ã€½  âœ³  âœ´  â‡  â–ª  â–«  â—»  â—¼  â—½  â—¾ 
â¬›  â¬œ  ğŸ”¶  ğŸ”·  ğŸ”¸  ğŸ”¹  ğŸ”º  ğŸ”»  ğŸ’   ğŸ”˜  ğŸ”²  ğŸ”³  âšª  âš«  ğŸ”´  ğŸ”µ 
ğŸ…¿
signal	ğŸš¥  ğŸš¦  ğŸ“¶
silhouette	ğŸ—£  ğŸ‘¤  ğŸ‘¥
singapore	ğŸ‡¸ğŸ‡¬
sint	ğŸ‡§ğŸ‡¶  ğŸ‡¸ğŸ‡½
skate	â›¸
skewer, stick	ğŸ¢  ğŸ¡
ski	ğŸ¿  â›·  ğŸ‚
skull	ğŸ’€  â˜ 
sleep	ğŸ˜ª  ğŸ˜´  ğŸ’¤  ğŸ›Œ  ğŸ›
sleuth, spy	ğŸ•µ
slice	ğŸ•  ğŸ°
slot	ğŸ°
slovak, slovakia	ğŸ‡¸ğŸ‡°
slovenia	ğŸ‡¸ğŸ‡®
smile, smiley	â˜º  ğŸ™‚  ğŸ˜  ğŸ˜ƒ  ğŸ˜„  ğŸ˜…  ğŸ˜†  ğŸ˜Š  ğŸ˜‹  ğŸ˜  ğŸ˜  ğŸ˜™  ğŸ˜‡  ğŸ˜ˆ  ğŸ˜¸  ğŸ˜º 
ğŸ˜»  ğŸ˜¼
smirk	ğŸ˜
smoking	ğŸš­  ğŸš¬
snail	ğŸŒ
snake	ğŸ
snow	ğŸ”  ğŸŒ¨  â„  â˜ƒ  â›„  ğŸ¿  â›·  ğŸ‚
snowboard	ğŸ‚
snowflake	â„
snowman	â˜ƒ  â›„
sob	ğŸ˜­
soccer	âš½
solomon	ğŸ‡¸ğŸ‡§
somalia	ğŸ‡¸ğŸ‡´
soon	ğŸ”œ
sos	ğŸ†˜
sound	ğŸ”‡  ğŸ”ˆ  ğŸ”‰  ğŸ”Š  ğŸ“¢  ğŸ“£  ğŸ“¯  ğŸ””  ğŸ”•  â–¶  â©  â­  â¯  â—€  âª  â® 
â«  â¬  â¸  â¹  âº  â  ğŸ¼  ğŸµ  ğŸ¶  ğŸ™  ğŸš  ğŸ›  ğŸ¤  ğŸ§  ğŸ·  ğŸ¸ 
ğŸ¹  ğŸº  ğŸ»  â˜  ğŸ“  ã€°
south	ğŸ‡¿ğŸ‡¦  ğŸ‡¬ğŸ‡¸  ğŸ‡°ğŸ‡·  ğŸ‡¸ğŸ‡¸  â¬‡
southeast	â†˜
southern	ğŸ‡¹ğŸ‡«
southwest	â†™
space	ğŸ‘½  ğŸ‘¾  ğŸŒŒ  ğŸš€  ğŸ›°  ğŸŒ‘  ğŸŒ’  ğŸŒ“  ğŸŒ”  ğŸŒ•  ğŸŒ–  ğŸŒ—  ğŸŒ˜  ğŸŒ™  ğŸŒ   â˜„
spade	â™ 
spain	ğŸ‡ªğŸ‡¸
sparkle	ğŸ’–  ğŸŒŸ  ğŸ‡  âœ¨  â‡
speak	ğŸ—£  ğŸ™Š
speaker, volume	ğŸ”‡  ğŸ”ˆ  ğŸ”‰  ğŸ”Š
speedboat	ğŸš¤
spider	ğŸ•·  ğŸ•¸
spiral	ğŸš  ğŸ—’  ğŸ—“
splashing	ğŸ’¦
splayed	ğŸ–
spock, vulcan	ğŸ––
sport	ğŸƒ  ğŸš²  ğŸš³  ğŸš´  ğŸšµ  ğŸ  ğŸ  âš½  âš¾  ğŸ€  ğŸˆ  ğŸ‰  ğŸ¾  ğŸ±  ğŸ³  â›³ 
ğŸŒ  â›¸  ğŸ£  ğŸ½  ğŸ¿  â›·  ğŸ‚  ğŸ„  ğŸ‡  ğŸŠ  â›¹  ğŸ‹  ğŸ…  ğŸ†  ğŸ
spouting	ğŸ³
square	â¹  â  â–ª  â–«  â—»  â—¼  â—½  â—¾  â¬›  â¬œ  ğŸ”²  ğŸ”³
stadium	ğŸŸ
star	ğŸ’«  ğŸŒƒ  ğŸŒŸ  ğŸŒ   *âƒ£  âœ¨  ğŸ”¯  âœ¡  â­  âœ´
station	ğŸš‰  â›½
statue	ğŸ—½  ğŸ—¿
steaming	ğŸœ  â˜•  â™¨
stew	ğŸ²
stop	ğŸš  â¹
stopwatch	â±
store	ğŸª  ğŸ¬
straight edge	ğŸ“
studio	ğŸ™
sudan	ğŸ‡¸ğŸ‡¸  ğŸ‡¸ğŸ‡©
suit	ğŸ•´  â™   â™¥  â™¦  â™£
sun	ğŸ˜  ğŸŒ»  ğŸŒ„  ğŸŒ…  ğŸŒ†  ğŸŒ‡  â˜€  ğŸŒ  â›…  ğŸŒ¤  ğŸŒ¥  ğŸŒ¦  â›±
sunflower	ğŸŒ»
sunglasses	ğŸ˜  ğŸ•¶
surfer, surfing	ğŸ„
suriname	ğŸ‡¸ğŸ‡·
surprised	ğŸ˜¯  ğŸ™€
sushi	ğŸ£
suspension	ğŸšŸ
swaziland	ğŸ‡¸ğŸ‡¿
sweat	ğŸ˜…  ğŸ˜“  ğŸ˜°  ğŸ’§  ğŸ’¦
sweden	ğŸ‡¸ğŸ‡ª
sweet	ğŸ   ğŸ¡  ğŸ¦  ğŸ§  ğŸ¨  ğŸ©  ğŸª  ğŸ‚  ğŸ°  ğŸ«  ğŸ¬  ğŸ­  ğŸ®  ğŸ¯
swim	ğŸ‘™  ğŸŠ
swimmer	ğŸŠ
swirl	ğŸ¥
switzerland	ğŸ‡¨ğŸ‡­
swords	âš”
symbol	Â©  Â®  â„¢
symbols	ğŸ”£ğŸ’® ğŸš® ğŸš« ğŸš­ ğŸš¯ ğŸš° ğŸš± â™¿ ğŸš¹ ğŸšº ğŸš» ğŸš¼ â›” 
ğŸ•› ğŸ•§ ğŸ• ğŸ•œ ğŸ•‘ ğŸ• ğŸ•’ ğŸ• ğŸ•“ ğŸ•Ÿ ğŸ•” ğŸ•  ğŸ•• ğŸ•¡ ğŸ•– ğŸ•¢ ğŸ•— ğŸ•£ ğŸ•˜ ğŸ•¤ ğŸ•™ ğŸ•¥ ğŸ•š ğŸ•¦ 
â™ˆ â™‰ â™Š â™‹ â™Œ â™ â™ â™ â™ â™‘ â™’ â™“ â› â™  â™¥ â™¦ â™£ 
ğŸ”€ ğŸ” ğŸ”‚ â–¶ â© â—€ âª ğŸ”¼ â« ğŸ”½ â¬ ğŸ“³ ğŸ“´ ğŸ“µ ğŸ“¶ ğŸ”— ğŸ”¯ 
ğŸ”± ğŸ’¯ â¬† â†— â¡ â†˜ â¬‡ â†™ â¬… â†– â†• â†” â†© â†ª â¤´ â¤µ ğŸ”ƒ 
ğŸ”„ ğŸ”™ ğŸ”š ğŸ”› ğŸ”œ ğŸ” â™» â­• âœ… â˜‘ âœ” âœ– âŒ â â• â– 
â— â° â¿ âœ³ âœ´ â‡ â–ª â–« â—» â—¼ â—½ â—¾ â¬› â¬œ ğŸ”¶ ğŸ”· ğŸ”¸ 
ğŸ”¹ ğŸ”º ğŸ”» ğŸ’  ğŸ”˜ ğŸ”² ğŸ”³ âšª âš« ğŸ”´ ğŸ”µ â€¼ â‰ â“ â” â• 
â— ã€° ğŸ” Â© Â® ğŸ”  ğŸ”¡ ğŸ”¢ ğŸ”£ ğŸ”¤ ğŸ…° ğŸ† ğŸ…± ğŸ†‘ ğŸ†’ ğŸ†“ â„¹ 
ğŸ†” ğŸ†• ğŸ†– ğŸ…¾ ğŸ†— ğŸ†˜ â„¢ ğŸ†™ ğŸ†š ğŸˆ ğŸˆ‚ ğŸˆ¹ ğŸ‰‘ ğŸˆ´ ğŸˆº ğŸ‰ ğŸˆ¯ 
ğŸˆ· ğŸˆ¶ ğŸˆµ ğŸˆš ğŸˆ¸ ãŠ— ğŸˆ² ãŠ™ ğŸˆ³
ğŸ’¤ ğŸ’¢ âš ğŸ”… ğŸ”†
ğŸ’Ÿ ğŸš³ ğŸ§ ğŸš· ğŸš¸ ğŸš¾ ğŸ›‚ ğŸ›ƒ ğŸ›„ ğŸ›… #âƒ£ 0âƒ£ 1âƒ£ 2âƒ£ 3âƒ£ 4âƒ£ 5âƒ£ 6âƒ£ 7âƒ£ 8âƒ£ 9âƒ£ ğŸ”Ÿ ğŸ¦ ğŸ’± ğŸ’² ğŸ’¹ ã€½ â“‚ ğŸ…¿
ğŸ•‰ âœ¡ â˜¯ âœ â˜¦ â›© â˜ª â˜® â˜¢ â˜£
â­ â¯ â® â¸ â¹ âº â *âƒ£  â£ ğŸ•³ ğŸ—¯
symbols-android	ğŸ’¤  ğŸ’¢  ğŸ’¥  ğŸ’¦  ğŸ’¨  ğŸ’«  ğŸ’®  ğŸš®  ğŸš«  ğŸš­  ğŸš¯  ğŸš°  ğŸš±  â™¿  ğŸš¹  ğŸšº 
ğŸš»  ğŸš¼  âš   â›”  âŒ›  â³  â°  ğŸ•›  ğŸ•§  ğŸ•  ğŸ•œ  ğŸ•‘  ğŸ•  ğŸ•’  ğŸ•  ğŸ•“ 
ğŸ•Ÿ  ğŸ•”  ğŸ•   ğŸ••  ğŸ•¡  ğŸ•–  ğŸ•¢  ğŸ•—  ğŸ•£  ğŸ•˜  ğŸ•¤  ğŸ•™  ğŸ•¥  ğŸ•š  ğŸ•¦  â™ˆ 
â™‰  â™Š  â™‹  â™Œ  â™  â™  â™  â™  â™‘  â™’  â™“  â›  ğŸŒŸ  ğŸŒ   â™   â™¥ 
â™¦  â™£  ğŸ”‡  ğŸ”ˆ  ğŸ”‰  ğŸ”Š  ğŸ”€  ğŸ”  ğŸ”‚  â–¶  â©  â—€  âª  ğŸ”¼  â«  ğŸ”½ 
â¬  ğŸ“³  ğŸ“´  ğŸ“µ  ğŸ“¶  ğŸ”…  ğŸ”†  ğŸ”  ğŸ”  ğŸ”¥  ğŸ’¡  âœ¨  ğŸ”–  ğŸ“§  ğŸ”’  ğŸ”“ 
ğŸ”  ğŸ”  ğŸ”‘  ğŸ”—  ğŸ”¯  ğŸ”±  ğŸ’¯  ğŸš©  â¬†  â†—  â¡  â†˜  â¬‡  â†™  â¬…  â†– 
â†•  â†”  â†©  â†ª  â¤´  â¤µ  ğŸ”ƒ  ğŸ”„  ğŸ”™  ğŸ”š  ğŸ”›  ğŸ”œ  ğŸ”  â™»  â­  â­• 
âœ…  â˜‘  âœ”  âœ–  âŒ  â  â•  â–  â—  â°  â¿  âœ³  âœ´  â‡  â–ª  â–« 
â—»  â—¼  â—½  â—¾  â¬›  â¬œ  ğŸ”¶  ğŸ”·  ğŸ”¸  ğŸ”¹  ğŸ”º  ğŸ”»  ğŸ’   ğŸ”˜  ğŸ”²  ğŸ”³ 
âšª  âš«  ğŸ”´  ğŸ”µ  â€¼  â‰  â“  â”  â•  â—  ã€°  ğŸ”  Â©  Â®  ğŸ”   ğŸ”¡ 
ğŸ”¢  ğŸ”£  ğŸ”¤  ğŸ…°  ğŸ†  ğŸ…±  ğŸ†‘  ğŸ†’  ğŸ†“  â„¹  ğŸ†”  ğŸ†•  ğŸ†–  ğŸ…¾  ğŸ†—  ğŸ†˜ 
â„¢  ğŸ†™  ğŸ†š  ğŸˆ  ğŸˆ‚  ğŸˆ¹  ğŸ‰‘  ğŸˆ´  ğŸˆº  ğŸ‰  ğŸˆ¯  ğŸˆ·  ğŸˆ¶  ğŸˆµ  ğŸˆš  ğŸˆ¸ 
ãŠ—  ğŸˆ²  ãŠ™  ğŸˆ³
symbols-apple	ğŸ’Ÿ  ğŸ’®  ğŸš³  ğŸ§  ğŸš®  ğŸš«  ğŸš­  ğŸš¯  ğŸš°  ğŸš±  ğŸš·  ğŸš¸  â™¿  ğŸš¹  ğŸšº  ğŸš» 
ğŸš¼  ğŸš¾  ğŸ›‚  ğŸ›ƒ  ğŸ›„  ğŸ›…  â›”  ğŸ•›  ğŸ•§  ğŸ•  ğŸ•œ  ğŸ•‘  ğŸ•  ğŸ•’  ğŸ•  ğŸ•“ 
ğŸ•Ÿ  ğŸ•”  ğŸ•   ğŸ••  ğŸ•¡  ğŸ•–  ğŸ•¢  ğŸ•—  ğŸ•£  ğŸ•˜  ğŸ•¤  ğŸ•™  ğŸ•¥  ğŸ•š  ğŸ•¦  â™ˆ 
â™‰  â™Š  â™‹  â™Œ  â™  â™  â™  â™  â™‘  â™’  â™“  â›  â™   â™¥  â™¦  â™£ 
ğŸ”€  ğŸ”  ğŸ”‚  â–¶  â©  â—€  âª  ğŸ”¼  â«  ğŸ”½  â¬  ğŸ“³  ğŸ“´  ğŸ“µ  #âƒ£  0âƒ£ 
1âƒ£  2âƒ£  3âƒ£  4âƒ£  5âƒ£  6âƒ£  7âƒ£  8âƒ£  9âƒ£  ğŸ”Ÿ  ğŸ“¶  ğŸ¦  ğŸ’±  ğŸ’²  ğŸ’¹  ğŸ”— 
ğŸ”¯  ğŸ”±  ğŸ’¯  â¬†  â†—  â¡  â†˜  â¬‡  â†™  â¬…  â†–  â†•  â†”  â†©  â†ª  â¤´ 
â¤µ  ğŸ”ƒ  ğŸ”„  ğŸ”™  ğŸ”š  ğŸ”›  ğŸ”œ  ğŸ”  â™»  â­•  âœ…  â˜‘  âœ”  âœ–  âŒ  â 
â•  â–  â—  â°  â¿  ã€½  âœ³  âœ´  â‡  â–ª  â–«  â—»  â—¼  â—½  â—¾  â¬› 
â¬œ  ğŸ”¶  ğŸ”·  ğŸ”¸  ğŸ”¹  ğŸ”º  ğŸ”»  ğŸ’   ğŸ”˜  ğŸ”²  ğŸ”³  âšª  âš«  ğŸ”´  ğŸ”µ  â€¼ 
â‰  â“  â”  â•  â—  ã€°  ğŸ”  Â©  Â®  ğŸ”   ğŸ”¡  ğŸ”¢  ğŸ”£  ğŸ”¤  ğŸ…°  ğŸ† 
ğŸ…±  ğŸ†‘  ğŸ†’  ğŸ†“  â„¹  ğŸ†”  â“‚  ğŸ†•  ğŸ†–  ğŸ…¾  ğŸ†—  ğŸ…¿  ğŸ†˜  â„¢  ğŸ†™  ğŸ†š 
ğŸˆ  ğŸˆ‚  ğŸˆ¹  ğŸ‰‘  ğŸˆ´  ğŸˆº  ğŸ‰  ğŸˆ¯  ğŸˆ·  ğŸˆ¶  ğŸˆµ  ğŸˆš  ğŸˆ¸  ãŠ—  ğŸˆ²  ãŠ™ 
ğŸˆ³
sympathy	ğŸ˜®
syria, syrian	ğŸ‡¸ğŸ‡¾
taiwan	ğŸ‡¹ğŸ‡¼
tajikistan	ğŸ‡¹ğŸ‡¯
tangerine	ğŸŠ
tanzania	ğŸ‡¹ğŸ‡¿
tao, taoist, yang, yin	â˜¯
tape, vhs, videocassette	ğŸ“¼
taurus	â™‰
taxi	ğŸš•  ğŸš–
tea	â˜•  ğŸµ
teacup	ğŸµ
tear	ğŸ˜‚  ğŸ˜¢  ğŸ˜­  ğŸ˜¹  ğŸ˜¿
telephone	â˜  ğŸ“
telescope	ğŸ”­
television, tv	ğŸ“º
tent	â›º  ğŸª
thailand	ğŸ‡¹ğŸ‡­
thermometer	ğŸŒ¡
thought	ğŸ’­
thumb	ğŸ‘  ğŸ‘
thunder	â›ˆ
tiger	ğŸ¯  ğŸ…
time	ğŸŒ„  ğŸŒ…  ğŸŒ†  ğŸŒ‡  âŒ›  â³  âŒš  â°  â±  â²  ğŸ•›  ğŸ•§  ğŸ•  ğŸ•œ  ğŸ•‘  ğŸ• 
ğŸ•’  ğŸ•  ğŸ•“  ğŸ•Ÿ  ğŸ•”  ğŸ•   ğŸ••  ğŸ•¡  ğŸ•–  ğŸ•¢  ğŸ•—  ğŸ•£  ğŸ•˜  ğŸ•¤  ğŸ•™  ğŸ•¥ 
ğŸ•š  ğŸ•¦  â™ˆ  â™‰  â™Š  â™‹  â™Œ  â™  â™  â™  â™  â™‘  â™’  â™“  ğŸŒ‘  ğŸŒ’ 
ğŸŒ“  ğŸŒ”  ğŸŒ•  ğŸŒ–  ğŸŒ—  ğŸŒ˜  ğŸŒ™  ğŸŒš
timer	âŒ›  â³  â²
tired	ğŸ˜©  ğŸ˜«
tm, trademark	â„¢
tobago, trinidad	ğŸ‡¹ğŸ‡¹
togo	ğŸ‡¹ğŸ‡¬
toilet	ğŸš½
tokelau	ğŸ‡¹ğŸ‡°
tokyo, tower	ğŸ—¼
tomato	ğŸ…
tonga	ğŸ‡¹ğŸ‡´
tongue	ğŸ˜›  ğŸ˜œ  ğŸ˜  ğŸ‘…
tool	âš“  ğŸ”  ğŸ”  ğŸ”¬  ğŸ”­  ğŸ”¥  ğŸ”¦  âœ‚  ğŸ”¨  â›  âš’  ğŸ›   ğŸ”§  ğŸ”©  âš™  ğŸ—œ 
âš—  âš–  ğŸ’‰  ğŸ”ª  ğŸ”«  ğŸ”®  ğŸ”±  ğŸ”°
top	ğŸ©  ğŸ”
tophat	ğŸ©
tornado	ğŸŒª
trackball	ğŸ–²
tractor	ğŸšœ
traffic	ğŸš¥  ğŸš¦  ğŸš¸  â›”
train	ğŸš‚  ğŸšƒ  ğŸš„  ğŸš…  ğŸš†  ğŸš‰  ğŸ›¤
tram, trolleybus	ğŸšƒ  ğŸšŠ  ğŸš‹  ğŸš
travel	ğŸš¶  â›‘  â™¨  ğŸ—¿  ğŸš‚  ğŸšƒ  ğŸš„  ğŸš…  ğŸš†  ğŸš‡  ğŸšˆ  ğŸš‰  ğŸšŠ  ğŸš  ğŸš  ğŸš‹ 
ğŸšŒ  ğŸš  ğŸš  ğŸš  ğŸš  ğŸš‘  ğŸš’  ğŸš“  ğŸš”  ğŸš•  ğŸš–  ğŸš—  ğŸš˜  ğŸš™  ğŸšš  ğŸš› 
ğŸšœ  ğŸš²  ğŸš³  ğŸš´  ğŸšµ  ğŸ  ğŸ  â›½  ğŸ›£  ğŸ›¤  ğŸš¨  âˆ  âš“  â›µ  ğŸš£  ğŸš¤ 
ğŸ›³  â›´  ğŸ›¥  ğŸš¢  âœˆ  ğŸ›©  ğŸ›«  ğŸ›¬  ğŸ’º  ğŸš  ğŸšŸ  ğŸš   ğŸš¡  ğŸš€  ğŸš®  ğŸš¥ 
ğŸš¦  ğŸš§  ğŸš«  ğŸš­  ğŸš¯  ğŸš°  ğŸš±  ğŸš·  ğŸš¸  â™¿  ğŸš¹  ğŸšº  ğŸš»  ğŸš¼  ğŸš¾  ğŸ›‚ 
ğŸ›ƒ  ğŸ›„  ğŸ›…  âš   â›”  ğŸšª  ğŸš½  ğŸš¿  ğŸ›€  ğŸ›  â›±  â›³  â›¸  â›·  ğŸ‡  ğŸŠ 
â›¹  â›  â›“  ğŸš¬  ğŸš©  â™»  âš¡  â­•
tray	ğŸ“¤  ğŸ“¥
tree	ğŸŒ²  ğŸŒ³  ğŸŒ´  ğŸ„  ğŸ‹
trend	ğŸ’¹  ğŸ“ˆ  ğŸ“‰
triangle	â–¶  â­  â¯  â—€  â®  ğŸ“
triumph, won	ğŸ˜¤
trolley	ğŸš
tropical	ğŸ   ğŸ¹
truck	ğŸš’  ğŸšš  ğŸš›
trumpet	ğŸº
tshirt	ğŸ‘•
tulip	ğŸŒ·
tunisia	ğŸ‡¹ğŸ‡³
turban	ğŸ‘³
turkey	ğŸ‡¹ğŸ‡·
turkmenistan	ğŸ‡¹ğŸ‡²
turtle	ğŸ¢
tuvalu	ğŸ‡¹ğŸ‡»
uganda	ğŸ‡ºğŸ‡¬
ukraine	ğŸ‡ºğŸ‡¦
umbrella	ğŸ–  ğŸŒ‚  â˜‚  â˜”  â›±
unamused, unhappy	ğŸ˜’
union	ğŸ‡ªğŸ‡º
united	ğŸ‡¹ğŸ‡¿  ğŸ‡¦ğŸ‡ª  ğŸ‡¬ğŸ‡§  ğŸ‡ºğŸ‡¸  ğŸ‡ºğŸ‡²  ğŸ‡»ğŸ‡®
unlock	ğŸ”“
up	â˜  ğŸ‘†  ğŸ‘  ğŸ”  ğŸ†™
uppercase	ğŸ” 
uruguay	ğŸ‡ºğŸ‡¾
uzbekistan	ğŸ‡ºğŸ‡¿
v, victory	âœŒ
valentine	ğŸ’
vanuatu	ğŸ‡»ğŸ‡º
vegetable	ğŸ…  ğŸ†
vehicle	ğŸš‚  ğŸšƒ  ğŸš„  ğŸš…  ğŸš†  ğŸš‡  ğŸšˆ  ğŸš‰  ğŸšŠ  ğŸš  ğŸš  ğŸš‹  ğŸšŒ  ğŸš  ğŸš  ğŸš 
ğŸš‘  ğŸš’  ğŸš“  ğŸš”  ğŸš•  ğŸš–  ğŸš—  ğŸš˜  ğŸš™  ğŸšš  ğŸš›  ğŸšœ  ğŸš²  ğŸš³  ğŸš£  ğŸš¤ 
ğŸ›³  ğŸ›¥  ğŸš¢  ğŸ›©  ğŸ›«  ğŸ›¬  ğŸš  ğŸšŸ  ğŸš   ğŸš¡  ğŸš€  ğŸ›°
venezuela	ğŸ‡»ğŸ‡ª
versus, vs	ğŸ†š
vertical	â¸
video	ğŸ“»  ğŸ“½  ğŸ“º  ğŸ“·  ğŸ“¸  ğŸ“¹  ğŸ“¼
video game	ğŸ®  ğŸ•¹
violin	ğŸ»
virgin islands	ğŸ‡»ğŸ‡¬  ğŸ‡»ğŸ‡®
virgo	â™
waning	ğŸŒ–  ğŸŒ˜
warning	âš 
wastebasket	ğŸ—‘
watch	âŒš
water	ğŸƒ  ğŸŒŠ  ğŸš°  ğŸš±  ğŸš¾  ğŸš¿
watermelon	ğŸ‰
wave	ğŸ‘‹  ğŸŒŠ  ğŸ”‰
waving	ğŸ‘‹  ğŸ³  ğŸ´
wavy	ã€°
waxing	ğŸŒ’  ğŸŒ”
weapon	ğŸ—¡  ğŸ”ª  âš”  ğŸ”«  ğŸ›¡
weary	ğŸ˜©  ğŸ™€
weather	ğŸ˜  ğŸ’§  ğŸŒ‹  ğŸŒ  ğŸŒƒ  ğŸŒ„  ğŸŒ…  ğŸŒ†  ğŸŒ‡  ğŸŒ‰  ğŸŒŠ  ğŸŒŒ  ğŸŒ‘  ğŸŒ’  ğŸŒ“  ğŸŒ” 
ğŸŒ•  ğŸŒ–  ğŸŒ—  ğŸŒ˜  ğŸŒ™  ğŸŒš  ğŸŒ›  ğŸŒœ  ğŸŒ¡  â˜€  ğŸŒ  ğŸŒ  â˜  â›…  â›ˆ  ğŸŒ¤ 
ğŸŒ¥  ğŸŒ¦  ğŸŒ§  ğŸŒ¨  ğŸŒ©  ğŸŒª  ğŸŒ«  ğŸŒ¬  ğŸŒ€  ğŸŒˆ  ğŸŒ‚  â˜‚  â˜”  â›±  â„  â˜ƒ 
â›„
web	ğŸ•¸
wedding	ğŸ‘°  ğŸ’’
weight	ğŸ‹  âš–
west	â¬…
whale	ğŸ³  ğŸ‹
wheel	ğŸ¡  â˜¸
whew	ğŸ˜¥
wind	ğŸƒ  ğŸŒ¬  ğŸ
wine	ğŸ·
wings	ğŸ’¸
wink	ğŸ˜‰  ğŸ˜œ
wolf	ğŸº
woman	ğŸ‘©  ğŸ‘µ  ğŸ‘¯  ğŸ‘«  ğŸ‘­  ğŸ‘š  ğŸ‘   ğŸ‘¡  ğŸ‘¢  ğŸ‘’  ğŸšº
womenâ€™s	ğŸšº
word	ğŸ’¤  â›  #âƒ£  0âƒ£  1âƒ£  2âƒ£  3âƒ£  4âƒ£  5âƒ£  6âƒ£  7âƒ£  8âƒ£  9âƒ£  ğŸ”Ÿ  â€¼  â‰ 
â“  â”  â•  â—  ğŸ”  Â©  Â®  ğŸ”   ğŸ”¡  ğŸ”¢  ğŸ”£  ğŸ”¤  ğŸ…°  ğŸ†  ğŸ…±  ğŸ†‘ 
ğŸ†’  ğŸ†“  â„¹  ğŸ†”  â“‚  ğŸ†•  ğŸ†–  ğŸ…¾  ğŸ†—  ğŸ…¿  ğŸ†˜  â„¢  ğŸ†™  ğŸ†š  ğŸˆ  ğŸˆ‚ 
ğŸˆ¹  ğŸ‰‘  ğŸˆ´  ğŸˆº  ğŸ‰  ğŸˆ¯  ğŸˆ·  ğŸˆ¶  ğŸˆµ  ğŸˆš  ğŸˆ¸  ãŠ—  ğŸˆ²  ãŠ™  ğŸˆ³
worker	ğŸ‘·
world	ğŸŒ  ğŸŒ  ğŸŒ  ğŸŒ  ğŸ—º
worried	ğŸ˜Ÿ
wrench	ğŸ›   ğŸ”§
write	âœ
yellow	ğŸ’›  ğŸ”°
yemen	ğŸ‡¾ğŸ‡ª
yen	ğŸ’´  ğŸ’¹
zambia	ğŸ‡¿ğŸ‡²
zimbabwe	ğŸ‡¿ğŸ‡¼
zodiac	â™ˆ  â™‰  â™Š  â™‹  â™Œ  â™  â™  â™  â™  â™‘  â™’  â™“  â›
zzz	ğŸ’¤
Aries, ram, zodiac	â™ˆğŸ
Taurus, bull, ox, zodiac	â™‰ğŸ‚
Gemini, twins, zodiac	â™ŠğŸ‘¬
crab, zodiac	â™‹
lion, zodiac	â™Œ
Virgo, maiden, virgin, zodiac	â™ğŸ‘§
Libra, balance, scales, justice, zodiac	â™âš–
scorpion, zodiac	â™
archer, zodiac	â™
capricorn, goat, zodiac	â™‘ğŸ
Aquarius, water, bearer, zodiac	â™’
Pisces, fish, zodiac	â™“ğŸŸ
Ophiuchus, serpent, snake, bearer, zodiac	â›ğŸ
animal	 ğŸ™ˆ  ğŸ™‰  ğŸ™Š ğŸ±  ğŸ˜¸  ğŸ˜¹  ğŸ˜º  ğŸ˜»  ğŸ˜¼  ğŸ˜½  ğŸ˜¾  ğŸ˜¿  ğŸ™€ 


























































