eye, speech, bubble, witness	ğŸ‘â€ğŸ—¨
man, couple, man	ğŸ‘¨â€â¤ï¸â€ğŸ‘¨
man, kiss, man	ğŸ‘¨â€â¤ï¸â€ğŸ’‹â€ğŸ‘¨
family, man, man, boy	ğŸ‘¨â€ğŸ‘¨â€ğŸ‘¦
family, man, man, boy, boy	ğŸ‘¨â€ğŸ‘¨â€ğŸ‘¦â€ğŸ‘¦
family, man, man, girl	ğŸ‘¨â€ğŸ‘¨â€ğŸ‘§
family, man, man, girl, boy	ğŸ‘¨â€ğŸ‘¨â€ğŸ‘§â€ğŸ‘¦
family, man, man, girl, girl	ğŸ‘¨â€ğŸ‘¨â€ğŸ‘§â€ğŸ‘§
family, man, woman, boy	ğŸ‘¨â€ğŸ‘©â€ğŸ‘¦
family, man, woman, boy, boy	ğŸ‘¨â€ğŸ‘©â€ğŸ‘¦â€ğŸ‘¦
family, man, woman, girl	ğŸ‘¨â€ğŸ‘©â€ğŸ‘§
family, man, woman, girl, boy	ğŸ‘¨â€ğŸ‘©â€ğŸ‘§â€ğŸ‘¦
family, man, woman, girl, girl	ğŸ‘¨â€ğŸ‘©â€ğŸ‘§â€ğŸ‘§
woman, couple, man	ğŸ‘©â€â¤ï¸â€ğŸ‘¨
woman, couple, woman	ğŸ‘©â€â¤ï¸â€ğŸ‘©
woman, kiss, man	ğŸ‘©â€â¤ï¸â€ğŸ’‹â€ğŸ‘¨
woman, kiss, woman	ğŸ‘©â€â¤ï¸â€ğŸ’‹â€ğŸ‘©
family, woman, woman, boy	ğŸ‘©â€ğŸ‘©â€ğŸ‘¦
family, woman, woman, boy, boy	ğŸ‘©â€ğŸ‘©â€ğŸ‘¦â€ğŸ‘¦
family, woman, woman, girl	ğŸ‘©â€ğŸ‘©â€ğŸ‘§
family, woman, woman, girl, boy	ğŸ‘©â€ğŸ‘©â€ğŸ‘§â€ğŸ‘¦
family, woman, woman, girl, girl	ğŸ‘©â€ğŸ‘©â€ğŸ‘§â€ğŸ‘§
cook, chef, cooking		ğŸ‘©â€ğŸ³ ğŸ‘¨â€ğŸ³
industrial worker, assembly worker, factory worker, manufacturing	ğŸ‘©â€ğŸ­ ğŸ‘¨â€ğŸ­
farmer, farm worker, rancher, gardener, farming	ğŸ‘©â€ğŸŒ¾ğŸ‘¨â€ğŸŒ¾
healthcare professional, doctor, nurse, therapist,...	ğŸ‘©â€âš• ğŸ‘¨â€âš•
tradesperson, mechanic, plumber, electrician	ğŸ‘©â€ğŸ”§ ğŸ‘¨â€ğŸ”§
office worker, business person, financial analyst, manager, architect, white-collar worker	ğŸ‘©â€ğŸ’¼ ğŸ‘¨â€ğŸ’¼
scientist, technologist, STEM professional, chemist, physicist, biologist, mathematician	ğŸ‘©â€ğŸ”¬ ğŸ‘¨â€ğŸ”¬
singer, entertainer, rock star	ğŸ‘©â€ğŸ¤ ğŸ‘¨â€ğŸ¤
student	ğŸ‘©â€ğŸ“ğŸ‘¨â€ğŸ“
teacher, professor, instructor	ğŸ‘©â€ğŸ« ğŸ‘¨â€ğŸ«
technology professional, coder, software developer, engineer, inventor	ğŸ‘©â€ğŸ’» ğŸ‘¨â€ğŸ’»