
# Generic annotations
island	ğŸ‡§ğŸ‡» ğŸ‡®ğŸ‡´ ğŸ‡­ğŸ‡² ğŸ‡¦ğŸ‡¨ ğŸ‡¹ğŸ‡¨ ğŸ‡¨ğŸ‡½ ğŸ‡®ğŸ‡¨ ğŸ‡°ğŸ‡¾ ğŸ‡¨ğŸ‡µ ğŸ‡¨ğŸ‡¨ ğŸ‡¨ğŸ‡° ğŸ‡«ğŸ‡´ ğŸ‡«ğŸ‡° ğŸ‡²ğŸ‡µ ğŸ‡²ğŸ‡­ ğŸ‡³ğŸ‡« ğŸ‡ºğŸ‡² ğŸ‡µğŸ‡³ ğŸ‡¬ğŸ‡¸ ğŸ‡¸ğŸ‡§ ğŸ‡»ğŸ‡¬ ğŸ‡»ğŸ‡®
new	ğŸ‡³ğŸ‡¨ ğŸ‡³ğŸ‡¿ ğŸ‡µğŸ‡¬
united	ğŸ‡ºğŸ‡¸ ğŸ‡ºğŸ‡² ğŸ‡»ğŸ‡® ğŸ‡¬ğŸ‡§ ğŸ‡¦ğŸ‡ª
republic	ğŸ‡¨ğŸ‡« ğŸ‡¨ğŸ‡¬ ğŸ‡¨ğŸ‡©
saint	ğŸ‡§ğŸ‡± ğŸ‡¸ğŸ‡­ ğŸ‡»ğŸ‡¨ ğŸ‡°ğŸ‡³ ğŸ‡±ğŸ‡¨ ğŸ‡µğŸ‡² ğŸ‡²ğŸ‡«
sint	ğŸ‡§ğŸ‡¶ ğŸ‡¸ğŸ‡½
south	ğŸ‡¿ğŸ‡¦ ğŸ‡¬ğŸ‡¸ ğŸ‡°ğŸ‡· ğŸ‡¸ğŸ‡¸
north	ğŸ‡²ğŸ‡µ ğŸ‡°ğŸ‡µ
west	ğŸ‡ªğŸ‡­
east	ğŸ‡¹ğŸ‡±

american, united states, virgin	ğŸ‡»ğŸ‡®
american, samoa	ğŸ‡¦ğŸ‡¸
united states, minor outlying	ğŸ‡ºğŸ‡²
british	ğŸ‡¬ğŸ‡§
british, indian ocean	ğŸ‡®ğŸ‡´
british, virgin	ğŸ‡»ğŸ‡¬
french	ğŸ‡¬ğŸ‡« ğŸ‡µğŸ‡«
french, antarctic	ğŸ‡¹ğŸ‡«
netherlands, caribbean	ğŸ‡§ğŸ‡¶

# Specific names for flags
stars and stripes	ğŸ‡ºğŸ‡¸
union jack		ğŸ‡¬ğŸ‡§

# Acronyms
us, usa	ğŸ‡º	ğŸ‡ºğŸ‡² ğŸ‡»ğŸ‡®
uk	ğŸ‡¬ğŸ‡§
uae	ğŸ‡¦ğŸ‡ª
drc	ğŸ‡¨ğŸ‡©

# Platforms
#other-android	ğŸ‡¨ğŸ‡³  ğŸ‡«ğŸ‡·  ğŸ‡©ğŸ‡ª  ğŸ‡®ğŸ‡¹  ğŸ‡¯ğŸ‡µ  ğŸ‡·ğŸ‡º  ğŸ‡°ğŸ‡·  ğŸ‡ªğŸ‡¸ ğŸ‡¬ğŸ‡§  ğŸ‡ºğŸ‡¸
#places-apple	ğŸ‡¨ğŸ‡³  ğŸ‡«ğŸ‡·  ğŸ‡©ğŸ‡ª  ğŸ‡®ğŸ‡¹  ğŸ‡¯ğŸ‡µ  ğŸ‡·ğŸ‡º  ğŸ‡°ğŸ‡·  ğŸ‡ªğŸ‡¸ ğŸ‡¬ğŸ‡§  ğŸ‡ºğŸ‡¸
flag	ğŸ‡¦ğŸ‡«  ğŸ‡¦ğŸ‡½  ğŸ‡¦ğŸ‡±  ğŸ‡©ğŸ‡¿  ğŸ‡¦ğŸ‡¸  ğŸ‡¦ğŸ‡©  ğŸ‡¦ğŸ‡´  ğŸ‡¦ğŸ‡® ğŸ‡¦ğŸ‡¶  ğŸ‡¦ğŸ‡¬  ğŸ‡¦ğŸ‡·  ğŸ‡¦ğŸ‡²  ğŸ‡¦ğŸ‡¼  ğŸ‡¦ğŸ‡¨  ğŸ‡¦ğŸ‡º  ğŸ‡¦ğŸ‡¹ 
ğŸ‡¦ğŸ‡¿  ğŸ‡§ğŸ‡¸  ğŸ‡§ğŸ‡­  ğŸ‡§ğŸ‡©  ğŸ‡§ğŸ‡§  ğŸ‡§ğŸ‡¾  ğŸ‡§ğŸ‡ª  ğŸ‡§ğŸ‡¿ ğŸ‡§ğŸ‡¯  ğŸ‡§ğŸ‡²  ğŸ‡§ğŸ‡¹  ğŸ‡§ğŸ‡´  ğŸ‡§ğŸ‡¦  ğŸ‡§ğŸ‡¼  ğŸ‡§ğŸ‡»  ğŸ‡§ğŸ‡· 
ğŸ‡®ğŸ‡´  ğŸ‡»ğŸ‡¬  ğŸ‡§ğŸ‡³  ğŸ‡§ğŸ‡¬  ğŸ‡§ğŸ‡«  ğŸ‡§ğŸ‡®  ğŸ‡°ğŸ‡­  ğŸ‡¨ğŸ‡² ğŸ‡¨ğŸ‡¦  ğŸ‡®ğŸ‡¨  ğŸ‡¨ğŸ‡»  ğŸ‡§ğŸ‡¶  ğŸ‡°ğŸ‡¾  ğŸ‡¨ğŸ‡«  ğŸ‡ªğŸ‡¦  ğŸ‡¹ğŸ‡© 
ğŸ‡¨ğŸ‡±  ğŸ‡¨ğŸ‡³  ğŸ‡¨ğŸ‡½  ğŸ‡¨ğŸ‡µ  ğŸ‡¨ğŸ‡¨  ğŸ‡¨ğŸ‡´  ğŸ‡°ğŸ‡²  ğŸ‡¨ğŸ‡¬ ğŸ‡¨ğŸ‡©  ğŸ‡¨ğŸ‡°  ğŸ‡¨ğŸ‡·  ğŸ‡¨ğŸ‡®  ğŸ‡­ğŸ‡·  ğŸ‡¨ğŸ‡º  ğŸ‡¨ğŸ‡¼  ğŸ‡¨ğŸ‡¾ 
ğŸ‡¨ğŸ‡¿  ğŸ‡©ğŸ‡°  ğŸ‡©ğŸ‡¬  ğŸ‡©ğŸ‡¯  ğŸ‡©ğŸ‡²  ğŸ‡©ğŸ‡´  ğŸ‡ªğŸ‡¨  ğŸ‡ªğŸ‡¬ ğŸ‡¸ğŸ‡»  ğŸ‡¬ğŸ‡¶  ğŸ‡ªğŸ‡·  ğŸ‡ªğŸ‡ª  ğŸ‡ªğŸ‡¹  ğŸ‡ªğŸ‡º  ğŸ‡«ğŸ‡°  ğŸ‡«ğŸ‡´ 
ğŸ‡«ğŸ‡¯  ğŸ‡«ğŸ‡®  ğŸ‡«ğŸ‡·  ğŸ‡¬ğŸ‡«  ğŸ‡µğŸ‡«  ğŸ‡¹ğŸ‡«  ğŸ‡¬ğŸ‡¦  ğŸ‡¬ğŸ‡² ğŸ‡¬ğŸ‡ª  ğŸ‡©ğŸ‡ª  ğŸ‡¬ğŸ‡­  ğŸ‡¬ğŸ‡®  ğŸ‡¬ğŸ‡·  ğŸ‡¬ğŸ‡±  ğŸ‡¬ğŸ‡©  ğŸ‡¬ğŸ‡µ 
ğŸ‡¬ğŸ‡º  ğŸ‡¬ğŸ‡¹  ğŸ‡¬ğŸ‡¬  ğŸ‡¬ğŸ‡³  ğŸ‡¬ğŸ‡¼  ğŸ‡¬ğŸ‡¾  ğŸ‡­ğŸ‡¹  ğŸ‡­ğŸ‡² ğŸ‡­ğŸ‡³  ğŸ‡­ğŸ‡°  ğŸ‡­ğŸ‡º  ğŸ‡®ğŸ‡¸  ğŸ‡®ğŸ‡³  ğŸ‡®ğŸ‡©  ğŸ‡®ğŸ‡·  ğŸ‡®ğŸ‡¶ 
ğŸ‡®ğŸ‡ª  ğŸ‡®ğŸ‡²  ğŸ‡®ğŸ‡±  ğŸ‡®ğŸ‡¹  ğŸ‡¯ğŸ‡²  ğŸ‡¯ğŸ‡µ  ğŸ‡¯ğŸ‡ª  ğŸ‡¯ğŸ‡´ ğŸ‡°ğŸ‡¿  ğŸ‡°ğŸ‡ª  ğŸ‡°ğŸ‡®  ğŸ‡½ğŸ‡°  ğŸ‡°ğŸ‡¼  ğŸ‡°ğŸ‡¬  ğŸ‡±ğŸ‡¦  ğŸ‡±ğŸ‡» 
ğŸ‡±ğŸ‡§  ğŸ‡±ğŸ‡¸  ğŸ‡±ğŸ‡·  ğŸ‡±ğŸ‡¾  ğŸ‡±ğŸ‡®  ğŸ‡±ğŸ‡¹  ğŸ‡±ğŸ‡º  ğŸ‡²ğŸ‡´ ğŸ‡²ğŸ‡°  ğŸ‡²ğŸ‡¬  ğŸ‡²ğŸ‡¼  ğŸ‡²ğŸ‡¾  ğŸ‡²ğŸ‡»  ğŸ‡²ğŸ‡±  ğŸ‡²ğŸ‡¹  ğŸ‡²ğŸ‡­ 
ğŸ‡²ğŸ‡¶  ğŸ‡²ğŸ‡·  ğŸ‡²ğŸ‡º  ğŸ‡¾ğŸ‡¹  ğŸ‡²ğŸ‡½  ğŸ‡«ğŸ‡²  ğŸ‡²ğŸ‡©  ğŸ‡²ğŸ‡¨ ğŸ‡²ğŸ‡³  ğŸ‡²ğŸ‡ª  ğŸ‡²ğŸ‡¸  ğŸ‡²ğŸ‡¦  ğŸ‡²ğŸ‡¿  ğŸ‡²ğŸ‡²  ğŸ‡³ğŸ‡¦  ğŸ‡³ğŸ‡· 
ğŸ‡³ğŸ‡µ  ğŸ‡³ğŸ‡±  ğŸ‡³ğŸ‡¨  ğŸ‡³ğŸ‡¿  ğŸ‡³ğŸ‡®  ğŸ‡³ğŸ‡ª  ğŸ‡³ğŸ‡¬  ğŸ‡³ğŸ‡º ğŸ‡³ğŸ‡«  ğŸ‡²ğŸ‡µ  ğŸ‡°ğŸ‡µ  ğŸ‡³ğŸ‡´  ğŸ‡´ğŸ‡²  ğŸ‡µğŸ‡°  ğŸ‡µğŸ‡¼  ğŸ‡µğŸ‡¸ 
ğŸ‡µğŸ‡¦  ğŸ‡µğŸ‡¬  ğŸ‡µğŸ‡¾  ğŸ‡µğŸ‡ª  ğŸ‡µğŸ‡­  ğŸ‡µğŸ‡³  ğŸ‡µğŸ‡±  ğŸ‡µğŸ‡¹ ğŸ‡µğŸ‡·  ğŸ‡¶ğŸ‡¦  ğŸ‡·ğŸ‡ª  ğŸ‡·ğŸ‡´  ğŸ‡·ğŸ‡º  ğŸ‡·ğŸ‡¼  ğŸ‡¼ğŸ‡¸  ğŸ‡¸ğŸ‡² 
ğŸ‡¸ğŸ‡¹  ğŸ‡¸ğŸ‡¦  ğŸ‡¸ğŸ‡³  ğŸ‡·ğŸ‡¸  ğŸ‡¸ğŸ‡¨  ğŸ‡¸ğŸ‡±  ğŸ‡¸ğŸ‡¬  ğŸ‡¸ğŸ‡½ ğŸ‡¸ğŸ‡°  ğŸ‡¸ğŸ‡®  ğŸ‡¸ğŸ‡§  ğŸ‡¸ğŸ‡´  ğŸ‡¿ğŸ‡¦  ğŸ‡¬ğŸ‡¸  ğŸ‡°ğŸ‡·  ğŸ‡¸ğŸ‡¸ 
ğŸ‡ªğŸ‡¸  ğŸ‡±ğŸ‡°  ğŸ‡§ğŸ‡±  ğŸ‡¸ğŸ‡­  ğŸ‡°ğŸ‡³  ğŸ‡±ğŸ‡¨  ğŸ‡²ğŸ‡«  ğŸ‡µğŸ‡² ğŸ‡»ğŸ‡¨  ğŸ‡¸ğŸ‡©  ğŸ‡¸ğŸ‡·  ğŸ‡¸ğŸ‡¯  ğŸ‡¸ğŸ‡¿  ğŸ‡¸ğŸ‡ª  ğŸ‡¨ğŸ‡­  ğŸ‡¸ğŸ‡¾ 
ğŸ‡¹ğŸ‡¼  ğŸ‡¹ğŸ‡¯  ğŸ‡¹ğŸ‡¿  ğŸ‡¹ğŸ‡­  ğŸ‡¹ğŸ‡±  ğŸ‡¹ğŸ‡¬  ğŸ‡¹ğŸ‡°  ğŸ‡¹ğŸ‡´ ğŸ‡¹ğŸ‡¹  ğŸ‡¹ğŸ‡¦  ğŸ‡¹ğŸ‡³  ğŸ‡¹ğŸ‡·  ğŸ‡¹ğŸ‡²  ğŸ‡¹ğŸ‡¨  ğŸ‡¹ğŸ‡»  ğŸ‡ºğŸ‡¬ 
ğŸ‡ºğŸ‡¦  ğŸ‡¦ğŸ‡ª  ğŸ‡¬ğŸ‡§  ğŸ‡ºğŸ‡¸  ğŸ‡ºğŸ‡¾  ğŸ‡ºğŸ‡²  ğŸ‡»ğŸ‡®  ğŸ‡ºğŸ‡¿ ğŸ‡»ğŸ‡º  ğŸ‡»ğŸ‡¦  ğŸ‡»ğŸ‡ª  ğŸ‡»ğŸ‡³  ğŸ‡¼ğŸ‡«  ğŸ‡ªğŸ‡­  ğŸ‡¾ğŸ‡ª  ğŸ‡¿ğŸ‡² 
ğŸ‡¿ğŸ‡¼

# #

afghanistan	ğŸ‡¦ğŸ‡«
south africa	ğŸ‡¿ğŸ‡¦
central african republic	ğŸ‡¨ğŸ‡«
Ã¥land	ğŸ‡¦ğŸ‡½
albania	ğŸ‡¦ğŸ‡±
algeria	ğŸ‡©ğŸ‡¿
united states, america	ğŸ‡ºğŸ‡¸ ğŸ‡ºğŸ‡² ğŸ‡»ğŸ‡®
andorra	ğŸ‡¦ğŸ‡©
angola	ğŸ‡¦ğŸ‡´
anguilla	ğŸ‡¦ğŸ‡®
antarctica	ğŸ‡¦ğŸ‡¶
antigua, barbuda	ğŸ‡¦ğŸ‡¬
antilles, curacao, curaÃ§ao	ğŸ‡¨ğŸ‡¼
saudi arabia	ğŸ‡¸ğŸ‡¦
argentina	ğŸ‡¦ğŸ‡·
armenia	ğŸ‡¦ğŸ‡²
aruba	ğŸ‡¦ğŸ‡¼
ascension	ğŸ‡¦ğŸ‡¨
australia	ğŸ‡¦ğŸ‡º
austria	ğŸ‡¦ğŸ‡¹
azerbaijan	ğŸ‡¦ğŸ‡¿
bahamas	ğŸ‡§ğŸ‡¸
bahrain	ğŸ‡§ğŸ‡­
bangladesh	ğŸ‡§ğŸ‡©
barbados	ğŸ‡§ğŸ‡§
barthelemy, barthÃ©lemy	ğŸ‡§ğŸ‡±
belarus	ğŸ‡§ğŸ‡¾
belgium	ğŸ‡§ğŸ‡ª
belize	ğŸ‡§ğŸ‡¿
benin	ğŸ‡§ğŸ‡¯
bermuda	ğŸ‡§ğŸ‡²
bhutan	ğŸ‡§ğŸ‡¹
bissau	ğŸ‡¬ğŸ‡¼
bolivia	ğŸ‡§ğŸ‡´
bonaire, eustatius, saba	ğŸ‡§ğŸ‡¶
bosnia, herzegovina	ğŸ‡§ğŸ‡¦
botswana	ğŸ‡§ğŸ‡¼
bouvet	ğŸ‡§ğŸ‡»
brazil	ğŸ‡§ğŸ‡·
brazzaville	ğŸ‡¨ğŸ‡¬
britain, great britain, cornwall, united kingdom, scotland, wales, northern ireland, england	ğŸ‡¬ğŸ‡§
brunei, darussalam	ğŸ‡§ğŸ‡³
bulgaria	ğŸ‡§ğŸ‡¬
burkina faso	ğŸ‡§ğŸ‡«
burma, myanmar	ğŸ‡²ğŸ‡²
burundi	ğŸ‡§ğŸ‡®
cabo, cape, verde	ğŸ‡¨ğŸ‡»
caicos, turks	ğŸ‡¹ğŸ‡¨
cambodia	ğŸ‡°ğŸ‡­
cameroon	ğŸ‡¨ğŸ‡²
canada	ğŸ‡¨ğŸ‡¦
canary	ğŸ‡®ğŸ‡¨
cayman	ğŸ‡°ğŸ‡¾
ceuta, melilla	ğŸ‡ªğŸ‡¦
chad	ğŸ‡¹ğŸ‡©
chile	ğŸ‡¨ğŸ‡±
china	ğŸ‡¨ğŸ‡³  ğŸ‡­ğŸ‡°  ğŸ‡²ğŸ‡´  ğŸ‡¹ğŸ‡¼
christmas	ğŸ‡¨ğŸ‡½
clipperton	ğŸ‡¨ğŸ‡µ
cote ivoire, cÃ´te ivoire, ivory coast	ğŸ‡¨ğŸ‡®
cocos, keeling	ğŸ‡¨ğŸ‡¨
colombia	ğŸ‡¨ğŸ‡´
comoros	ğŸ‡°ğŸ‡²
congo	ğŸ‡¨ğŸ‡¬  ğŸ‡¨ğŸ‡©
republic of the congo, congo republic, congo-brazzaville, brazzaville	ğŸ‡¨ğŸ‡¬
democratic republic of congo, congo-kinshasa, kinshasa	ğŸ‡¨ğŸ‡©
cook	ğŸ‡¨ğŸ‡°
costa rica	ğŸ‡¨ğŸ‡·
croatia	ğŸ‡­ğŸ‡·
cuba	ğŸ‡¨ğŸ‡º
tristan da cunha	ğŸ‡¹ğŸ‡¦
cyprus	ğŸ‡¨ğŸ‡¾
czech republic	ğŸ‡¨ğŸ‡¿
denmark	ğŸ‡©ğŸ‡°
diego garcia	ğŸ‡©ğŸ‡¬
djibouti	ğŸ‡©ğŸ‡¯
dominica	ğŸ‡©ğŸ‡²
dominican republic	ğŸ‡©ğŸ‡´
maarten	ğŸ‡¸ğŸ‡½
ecuador	ğŸ‡ªğŸ‡¨
egypt	ğŸ‡ªğŸ‡¬
el salvador	ğŸ‡¸ğŸ‡»
emirates	ğŸ‡¦ğŸ‡ª
equatorial guinea	ğŸ‡¬ğŸ‡¶
eritrea	ğŸ‡ªğŸ‡·
estonia	ğŸ‡ªğŸ‡ª
ethiopia	ğŸ‡ªğŸ‡¹
european union	ğŸ‡ªğŸ‡º
faroe	ğŸ‡«ğŸ‡´
falkland, falklands, islas, malvinas	ğŸ‡«ğŸ‡°
fiji	ğŸ‡«ğŸ‡¯
finland	ğŸ‡«ğŸ‡®
flag	ğŸ‡¦ğŸ‡«  ğŸ‡¦ğŸ‡½  ğŸ‡¦ğŸ‡±  ğŸ‡©ğŸ‡¿  ğŸ‡¦ğŸ‡¸  ğŸ‡¦ğŸ‡©  ğŸ‡¦ğŸ‡´  ğŸ‡¦ğŸ‡® ğŸ‡¦ğŸ‡¶  ğŸ‡¦ğŸ‡¬  ğŸ‡¦ğŸ‡·  ğŸ‡¦ğŸ‡²  ğŸ‡¦ğŸ‡¼  ğŸ‡¦ğŸ‡¨  ğŸ‡¦ğŸ‡º  ğŸ‡¦ğŸ‡¹ 
ğŸ‡¦ğŸ‡¿  ğŸ‡§ğŸ‡¸  ğŸ‡§ğŸ‡­  ğŸ‡§ğŸ‡©  ğŸ‡§ğŸ‡§  ğŸ‡§ğŸ‡¾  ğŸ‡§ğŸ‡ª  ğŸ‡§ğŸ‡¿ ğŸ‡§ğŸ‡¯  ğŸ‡§ğŸ‡²  ğŸ‡§ğŸ‡¹  ğŸ‡§ğŸ‡´  ğŸ‡§ğŸ‡¦  ğŸ‡§ğŸ‡¼  ğŸ‡§ğŸ‡»  ğŸ‡§ğŸ‡· 
ğŸ‡®ğŸ‡´  ğŸ‡»ğŸ‡¬  ğŸ‡§ğŸ‡³  ğŸ‡§ğŸ‡¬  ğŸ‡§ğŸ‡«  ğŸ‡§ğŸ‡®  ğŸ‡°ğŸ‡­  ğŸ‡¨ğŸ‡² ğŸ‡¨ğŸ‡¦  ğŸ‡®ğŸ‡¨  ğŸ‡¨ğŸ‡»  ğŸ‡§ğŸ‡¶  ğŸ‡°ğŸ‡¾  ğŸ‡¨ğŸ‡«  ğŸ‡ªğŸ‡¦  ğŸ‡¹ğŸ‡© 
ğŸ‡¨ğŸ‡±  ğŸ‡¨ğŸ‡³  ğŸ‡¨ğŸ‡½  ğŸ‡¨ğŸ‡µ  ğŸ‡¨ğŸ‡¨  ğŸ‡¨ğŸ‡´  ğŸ‡°ğŸ‡²  ğŸ‡¨ğŸ‡¬ ğŸ‡¨ğŸ‡©  ğŸ‡¨ğŸ‡°  ğŸ‡¨ğŸ‡·  ğŸ‡¨ğŸ‡®  ğŸ‡­ğŸ‡·  ğŸ‡¨ğŸ‡º  ğŸ‡¨ğŸ‡¼  ğŸ‡¨ğŸ‡¾ 
ğŸ‡¨ğŸ‡¿  ğŸ‡©ğŸ‡°  ğŸ‡©ğŸ‡¬  ğŸ‡©ğŸ‡¯  ğŸ‡©ğŸ‡²  ğŸ‡©ğŸ‡´  ğŸ‡ªğŸ‡¨  ğŸ‡ªğŸ‡¬ ğŸ‡¸ğŸ‡»  ğŸ‡¬ğŸ‡¶  ğŸ‡ªğŸ‡·  ğŸ‡ªğŸ‡ª  ğŸ‡ªğŸ‡¹  ğŸ‡ªğŸ‡º  ğŸ‡«ğŸ‡°  ğŸ‡«ğŸ‡´ 
ğŸ‡«ğŸ‡¯  ğŸ‡«ğŸ‡®  ğŸ‡«ğŸ‡·  ğŸ‡¬ğŸ‡«  ğŸ‡µğŸ‡«  ğŸ‡¹ğŸ‡«  ğŸ‡¬ğŸ‡¦  ğŸ‡¬ğŸ‡² ğŸ‡¬ğŸ‡ª  ğŸ‡©ğŸ‡ª  ğŸ‡¬ğŸ‡­  ğŸ‡¬ğŸ‡®  ğŸ‡¬ğŸ‡·  ğŸ‡¬ğŸ‡±  ğŸ‡¬ğŸ‡©  ğŸ‡¬ğŸ‡µ 
ğŸ‡¬ğŸ‡º  ğŸ‡¬ğŸ‡¹  ğŸ‡¬ğŸ‡¬  ğŸ‡¬ğŸ‡³  ğŸ‡¬ğŸ‡¼  ğŸ‡¬ğŸ‡¾  ğŸ‡­ğŸ‡¹  ğŸ‡­ğŸ‡² ğŸ‡­ğŸ‡³  ğŸ‡­ğŸ‡°  ğŸ‡­ğŸ‡º  ğŸ‡®ğŸ‡¸  ğŸ‡®ğŸ‡³  ğŸ‡®ğŸ‡©  ğŸ‡®ğŸ‡·  ğŸ‡®ğŸ‡¶ 
ğŸ‡®ğŸ‡ª  ğŸ‡®ğŸ‡²  ğŸ‡®ğŸ‡±  ğŸ‡®ğŸ‡¹  ğŸ‡¯ğŸ‡²  ğŸ‡¯ğŸ‡µ  ğŸ‡¯ğŸ‡ª  ğŸ‡¯ğŸ‡´ ğŸ‡°ğŸ‡¿  ğŸ‡°ğŸ‡ª  ğŸ‡°ğŸ‡®  ğŸ‡½ğŸ‡°  ğŸ‡°ğŸ‡¼  ğŸ‡°ğŸ‡¬  ğŸ‡±ğŸ‡¦  ğŸ‡±ğŸ‡» 
ğŸ‡±ğŸ‡§  ğŸ‡±ğŸ‡¸  ğŸ‡±ğŸ‡·  ğŸ‡±ğŸ‡¾  ğŸ‡±ğŸ‡®  ğŸ‡±ğŸ‡¹  ğŸ‡±ğŸ‡º  ğŸ‡²ğŸ‡´ ğŸ‡²ğŸ‡°  ğŸ‡²ğŸ‡¬  ğŸ‡²ğŸ‡¼  ğŸ‡²ğŸ‡¾  ğŸ‡²ğŸ‡»  ğŸ‡²ğŸ‡±  ğŸ‡²ğŸ‡¹  ğŸ‡²ğŸ‡­ 
ğŸ‡²ğŸ‡¶  ğŸ‡²ğŸ‡·  ğŸ‡²ğŸ‡º  ğŸ‡¾ğŸ‡¹  ğŸ‡²ğŸ‡½  ğŸ‡«ğŸ‡²  ğŸ‡²ğŸ‡©  ğŸ‡²ğŸ‡¨ ğŸ‡²ğŸ‡³  ğŸ‡²ğŸ‡ª  ğŸ‡²ğŸ‡¸  ğŸ‡²ğŸ‡¦  ğŸ‡²ğŸ‡¿  ğŸ‡²ğŸ‡²  ğŸ‡³ğŸ‡¦  ğŸ‡³ğŸ‡· 
ğŸ‡³ğŸ‡µ  ğŸ‡³ğŸ‡±  ğŸ‡³ğŸ‡¨  ğŸ‡³ğŸ‡¿  ğŸ‡³ğŸ‡®  ğŸ‡³ğŸ‡ª  ğŸ‡³ğŸ‡¬  ğŸ‡³ğŸ‡º ğŸ‡³ğŸ‡«  ğŸ‡²ğŸ‡µ  ğŸ‡°ğŸ‡µ  ğŸ‡³ğŸ‡´  ğŸ‡´ğŸ‡²  ğŸ‡µğŸ‡°  ğŸ‡µğŸ‡¼  ğŸ‡µğŸ‡¸ 
ğŸ‡µğŸ‡¦  ğŸ‡µğŸ‡¬  ğŸ‡µğŸ‡¾  ğŸ‡µğŸ‡ª  ğŸ‡µğŸ‡­  ğŸ‡µğŸ‡³  ğŸ‡µğŸ‡±  ğŸ‡µğŸ‡¹ ğŸ‡µğŸ‡·  ğŸ‡¶ğŸ‡¦  ğŸ‡·ğŸ‡ª  ğŸ‡·ğŸ‡´  ğŸ‡·ğŸ‡º  ğŸ‡·ğŸ‡¼  ğŸ‡¼ğŸ‡¸  ğŸ‡¸ğŸ‡² 
ğŸ‡¸ğŸ‡¹  ğŸ‡¸ğŸ‡¦  ğŸ‡¸ğŸ‡³  ğŸ‡·ğŸ‡¸  ğŸ‡¸ğŸ‡¨  ğŸ‡¸ğŸ‡±  ğŸ‡¸ğŸ‡¬  ğŸ‡¸ğŸ‡½ ğŸ‡¸ğŸ‡°  ğŸ‡¸ğŸ‡®  ğŸ‡¸ğŸ‡§  ğŸ‡¸ğŸ‡´  ğŸ‡¿ğŸ‡¦  ğŸ‡¬ğŸ‡¸  ğŸ‡°ğŸ‡·  ğŸ‡¸ğŸ‡¸ 
ğŸ‡ªğŸ‡¸  ğŸ‡±ğŸ‡°  ğŸ‡§ğŸ‡±  ğŸ‡¸ğŸ‡­  ğŸ‡°ğŸ‡³  ğŸ‡±ğŸ‡¨  ğŸ‡²ğŸ‡«  ğŸ‡µğŸ‡² ğŸ‡»ğŸ‡¨  ğŸ‡¸ğŸ‡©  ğŸ‡¸ğŸ‡·  ğŸ‡¸ğŸ‡¯  ğŸ‡¸ğŸ‡¿  ğŸ‡¸ğŸ‡ª  ğŸ‡¨ğŸ‡­  ğŸ‡¸ğŸ‡¾ 
ğŸ‡¹ğŸ‡¼  ğŸ‡¹ğŸ‡¯  ğŸ‡¹ğŸ‡¿  ğŸ‡¹ğŸ‡­  ğŸ‡¹ğŸ‡±  ğŸ‡¹ğŸ‡¬  ğŸ‡¹ğŸ‡°  ğŸ‡¹ğŸ‡´ ğŸ‡¹ğŸ‡¹  ğŸ‡¹ğŸ‡¦  ğŸ‡¹ğŸ‡³  ğŸ‡¹ğŸ‡·  ğŸ‡¹ğŸ‡²  ğŸ‡¹ğŸ‡¨  ğŸ‡¹ğŸ‡»  ğŸ‡ºğŸ‡¬ 
ğŸ‡ºğŸ‡¦  ğŸ‡¦ğŸ‡ª  ğŸ‡¬ğŸ‡§  ğŸ‡ºğŸ‡¸  ğŸ‡ºğŸ‡¾  ğŸ‡ºğŸ‡²  ğŸ‡»ğŸ‡®  ğŸ‡ºğŸ‡¿ ğŸ‡»ğŸ‡º  ğŸ‡»ğŸ‡¦  ğŸ‡»ğŸ‡ª  ğŸ‡»ğŸ‡³  ğŸ‡¼ğŸ‡«  ğŸ‡ªğŸ‡­  ğŸ‡¾ğŸ‡ª  ğŸ‡¿ğŸ‡² 
ğŸ‡¿ğŸ‡¼
france	ğŸ‡«ğŸ‡·
french	ğŸ‡¬ğŸ‡«  ğŸ‡µğŸ‡«  ğŸ‡¹ğŸ‡«  ğŸ‡²ğŸ‡«
futuna, wallis	ğŸ‡¼ğŸ‡«
gabon	ğŸ‡¬ğŸ‡¦
gambia	ğŸ‡¬ğŸ‡²
georgia	ğŸ‡¬ğŸ‡ª  ğŸ‡¬ğŸ‡¸
germany	ğŸ‡©ğŸ‡ª
ghana	ğŸ‡¬ğŸ‡­
gibraltar	ğŸ‡¬ğŸ‡®
greece	ğŸ‡¬ğŸ‡·
greenland	ğŸ‡¬ğŸ‡±
grenada	ğŸ‡¬ğŸ‡©
grenadines, vincent	ğŸ‡»ğŸ‡¨
guadeloupe	ğŸ‡¬ğŸ‡µ
guam	ğŸ‡¬ğŸ‡º
guatemala	ğŸ‡¬ğŸ‡¹
guernsey	ğŸ‡¬ğŸ‡¬
guiana	ğŸ‡¬ğŸ‡«
guinea	ğŸ‡¬ğŸ‡¶  ğŸ‡¬ğŸ‡³  ğŸ‡¬ğŸ‡¼  ğŸ‡µğŸ‡¬
guyana	ğŸ‡¬ğŸ‡¾
haiti	ğŸ‡­ğŸ‡¹
heard, mcdonald	ğŸ‡­ğŸ‡²
helena	ğŸ‡¸ğŸ‡­
vatican	ğŸ‡»ğŸ‡¦
honduras	ğŸ‡­ğŸ‡³
hong kong	ğŸ‡­ğŸ‡°
hungary	ğŸ‡­ğŸ‡º
iceland	ğŸ‡®ğŸ‡¸
india	ğŸ‡®ğŸ‡³
chagos	ğŸ‡®ğŸ‡´
indonesia	ğŸ‡®ğŸ‡©
iran	ğŸ‡®ğŸ‡·
iraq	ğŸ‡®ğŸ‡¶
ireland	ğŸ‡®ğŸ‡ª  ğŸ‡¬ğŸ‡§
isle of man	ğŸ‡®ğŸ‡²
israel	ğŸ‡®ğŸ‡±
italy	ğŸ‡®ğŸ‡¹
jamaica	ğŸ‡¯ğŸ‡²
jan mayen, svalbard	ğŸ‡¸ğŸ‡¯
japan	ğŸ‡¯ğŸ‡µ
jersey	ğŸ‡¯ğŸ‡ª
jordan	ğŸ‡¯ğŸ‡´
kazakhstan	ğŸ‡°ğŸ‡¿
kenya	ğŸ‡°ğŸ‡ª
kiribati	ğŸ‡°ğŸ‡®
kitts, nevis	ğŸ‡°ğŸ‡³
korea	ğŸ‡°ğŸ‡µ  ğŸ‡°ğŸ‡·
kosovo	ğŸ‡½ğŸ‡°
kuwait	ğŸ‡°ğŸ‡¼
kyrgyzstan	ğŸ‡°ğŸ‡¬
sri lanka	ğŸ‡±ğŸ‡°
laos	ğŸ‡±ğŸ‡¦
latvia	ğŸ‡±ğŸ‡»
lebanon	ğŸ‡±ğŸ‡§
lesotho	ğŸ‡±ğŸ‡¸
east timor, timor-leste	ğŸ‡¹ğŸ‡±
liberia	ğŸ‡±ğŸ‡·
libya	ğŸ‡±ğŸ‡¾
liechtenstein	ğŸ‡±ğŸ‡®
lithuania	ğŸ‡±ğŸ‡¹
lucia	ğŸ‡±ğŸ‡¨
luxembourg	ğŸ‡±ğŸ‡º
macao, macau	ğŸ‡²ğŸ‡´
macedonia	ğŸ‡²ğŸ‡°
madagascar	ğŸ‡²ğŸ‡¬
malawi	ğŸ‡²ğŸ‡¼
malaysia	ğŸ‡²ğŸ‡¾
maldives	ğŸ‡²ğŸ‡»
mali	ğŸ‡²ğŸ‡±
malta	ğŸ‡²ğŸ‡¹
northern mariana, mariana	ğŸ‡²ğŸ‡µ
marshall	ğŸ‡²ğŸ‡­
martin	ğŸ‡²ğŸ‡«
martinique	ğŸ‡²ğŸ‡¶
mauritania	ğŸ‡²ğŸ‡·
mauritius	ğŸ‡²ğŸ‡º
mayotte	ğŸ‡¾ğŸ‡¹
mexico	ğŸ‡²ğŸ‡½
micronesia	ğŸ‡«ğŸ‡²
miquelon, pierre	ğŸ‡µğŸ‡²
moldova	ğŸ‡²ğŸ‡©
monaco	ğŸ‡²ğŸ‡¨
mongolia	ğŸ‡²ğŸ‡³
montenegro	ğŸ‡²ğŸ‡ª
montserrat	ğŸ‡²ğŸ‡¸
morocco	ğŸ‡²ğŸ‡¦
mozambique	ğŸ‡²ğŸ‡¿
viet nam, vietnam	ğŸ‡»ğŸ‡³
namibia	ğŸ‡³ğŸ‡¦
nauru	ğŸ‡³ğŸ‡·
nepal	ğŸ‡³ğŸ‡µ
netherlands	ğŸ‡³ğŸ‡±
new caledonia	ğŸ‡³ğŸ‡¨
new zealand	ğŸ‡³ğŸ‡¿
nicaragua	ğŸ‡³ğŸ‡®
niger	ğŸ‡³ğŸ‡ª
nigeria	ğŸ‡³ğŸ‡¬
niue	ğŸ‡³ğŸ‡º
norfolk	ğŸ‡³ğŸ‡«
north korea	ğŸ‡°ğŸ‡µ
norway	ğŸ‡³ğŸ‡´
oman	ğŸ‡´ğŸ‡²
pakistan	ğŸ‡µğŸ‡°
palau	ğŸ‡µğŸ‡¼
palestine	ğŸ‡µğŸ‡¸
panama	ğŸ‡µğŸ‡¦
papua new guinea	ğŸ‡µğŸ‡¬
paraguay	ğŸ‡µğŸ‡¾
peru	ğŸ‡µğŸ‡ª
philippines	ğŸ‡µğŸ‡­
pitcairn	ğŸ‡µğŸ‡³
poland	ğŸ‡µğŸ‡±
polynesia	ğŸ‡µğŸ‡«
portugal	ğŸ‡µğŸ‡¹
principe, prÃ­ncipe, sao tome, sÃ£o tomÃ©	ğŸ‡¸ğŸ‡¹
puerto rico	ğŸ‡µğŸ‡·
qatar	ğŸ‡¶ğŸ‡¦
reunion, rÃ©union	ğŸ‡·ğŸ‡ª
romania	ğŸ‡·ğŸ‡´
russia	ğŸ‡·ğŸ‡º
rwanda	ğŸ‡·ğŸ‡¼
sahara, western sahara	ğŸ‡ªğŸ‡­
samoa	ğŸ‡¦ğŸ‡¸  ğŸ‡¼ğŸ‡¸
san marino	ğŸ‡¸ğŸ‡²
south georgia, south sandwich	ğŸ‡¬ğŸ‡¸
senegal	ğŸ‡¸ğŸ‡³
serbia	ğŸ‡·ğŸ‡¸
seychelles	ğŸ‡¸ğŸ‡¨
sierra leone	ğŸ‡¸ğŸ‡±
singapore	ğŸ‡¸ğŸ‡¬
slovakia	ğŸ‡¸ğŸ‡°
slovenia	ğŸ‡¸ğŸ‡®
solomon	ğŸ‡¸ğŸ‡§
somalia	ğŸ‡¸ğŸ‡´
south korea	ğŸ‡°ğŸ‡·
south sudan	ğŸ‡¸ğŸ‡¸
spain	ğŸ‡ªğŸ‡¸
sudan	ğŸ‡¸ğŸ‡¸  ğŸ‡¸ğŸ‡©
suriname	ğŸ‡¸ğŸ‡·
swaziland	ğŸ‡¸ğŸ‡¿
sweden	ğŸ‡¸ğŸ‡ª
switzerland	ğŸ‡¨ğŸ‡­
syria	ğŸ‡¸ğŸ‡¾
taiwan	ğŸ‡¹ğŸ‡¼
tajikistan	ğŸ‡¹ğŸ‡¯
tanzania	ğŸ‡¹ğŸ‡¿
thailand	ğŸ‡¹ğŸ‡­
tobago, trinidad	ğŸ‡¹ğŸ‡¹
togo	ğŸ‡¹ğŸ‡¬
tokelau	ğŸ‡¹ğŸ‡°
tonga	ğŸ‡¹ğŸ‡´
tunisia	ğŸ‡¹ğŸ‡³
turkey	ğŸ‡¹ğŸ‡·
turkmenistan	ğŸ‡¹ğŸ‡²
tuvalu	ğŸ‡¹ğŸ‡»
uganda	ğŸ‡ºğŸ‡¬
ukraine	ğŸ‡ºğŸ‡¦
uruguay	ğŸ‡ºğŸ‡¾
uzbekistan	ğŸ‡ºğŸ‡¿
vanuatu	ğŸ‡»ğŸ‡º
venezuela	ğŸ‡»ğŸ‡ª
virgin	ğŸ‡»ğŸ‡¬ ğŸ‡»ğŸ‡®
yemen	ğŸ‡¾ğŸ‡ª
zambia	ğŸ‡¿ğŸ‡²
zimbabwe	ğŸ‡¿ğŸ‡¼
